------text-----	---predicted_word---	-----true_word-----
ank	ऐंक		अंक
anka	ऐंक		अंक
ankit	अंकित		अंकित
anakon	आनकों		अंकों
ankhon	आंखों		अंकों
ankon	एंकोन		अंकों
angkor	एंगकोर		अंकोर
ankor	एंकोर		अंकोर
angaarak	अंगारक		अंगारक
angarak	अंगारक		अंगारक
angraji	अंग्रजी		अंग्रज़ी
angreji	अंग्रजी		अंग्रज़ी
angrzi	अंग्रजी		अंग्रज़ी
antah	अंतह		अंतः
antaha	अंतह		अंतः
antarmukh	अंतरमुख्य		अंतर्मुख
antmurkh	अंतमूर्ख		अंतर्मुख
antrmukh	अंतरमुख		अंतर्मुख
andrabee	अंदराबी		अंद्राबी
andrabi	अंद्राबी		अंद्राबी
andha	आंध		अंधा
andhapan	अंधपन		अंधापन
andheri	अंदेरी		अंधेरी
ambaani	अंबानी		अंबानी
ambani	अंबानी		अंबानी
akram	अक्रम		अकरम
acapulco	एकापल्को		अकापुल्को
akapulko	आकपूलकों		अकापुल्को
akhand	अखंड		अखंड
akhil	अखिल		अखिल
agavai	अगवाई		अगवाई
agvaai	अगवाई		अगवाई
augustine	ऑगस्टीन		अगस्टाइन
augustustine	ऑगस्टस्टाइन		अगस्टाइन
agsta	अजस्ट		अगस्ता
agusta	अगस्ट		अगस्ता
augusta	ऑगस्ट		अगस्ता
agr	आगरा		अग्र
agra	आगरा		अग्र
achambha	अचंभ		अचंभा
achanbha	अचंभ		अचंभा
achievement	अच्छेविमेंट		अचीवमेंट
achivement	अचिवेमेंट		अचीवमेंट
acchi	अच्छी		अच्छी
achchi	अच्छि		अच्छी
achhi	अछी		अच्छी
achyut	अच्युत		अच्युत
achhanera	एच्छानर		अछनेरा
achnera	अचनेर		अछनेरा
ajmeedh	अजमीद		अजमीढ़
ajhar	अजहर		अजहर
azhar	अजहर		अजहर
ajit	अजीत		अजित
agnat	अज्ञात		अज्ञात
agyaat	अज्ञात		अज्ञात
agyat	अज्ञात		अज्ञात
atakta	अटक्त		अटकता
atkata	अटकता		अटकता
atake	अटके		अटके
atke	एटी		अटके
atwaal	आतवाल		अटवाल
atwal	आतवाल		अटवाल
attahasa	अत्तहस		अट्टहास
atthaas	अत्थास		अट्टहास
atthas	अत्थास		अट्टहास
addon	आधड़न		अड्डों
athak	अथक		अथक
atharv	अथर्व		अथर्व
atharva	अथर्व		अथर्व
adad	आदाद		अदद
adaani	अदानी		अदाणी
adani	अदानी		अदाणी
advait	आद्वैत		अद्वैत
adwait	आद्वैत		अद्वैत
advaitvaad	अद्वैतवाद		अद्वैतवाद
advaitwad	आद्वैतवाद		अद्वैतवाद
adhivas	अधिवास		अधिवास
adhiwas	अधिवास		अधिवास
advivas	अद्विवास		अधिवास
adhiik	अधीक		अधीक
adhik	अधिक		अधीक
adhyayanarat	अध्ययनारात		अध्ययनरत
adhyayanrat	अध्ययनरता		अध्ययनरत
adhyaynrat	अध्ययनरता		अध्ययनरत
anant	अनंत		अनंत
ananti	अनंती		अनंती
angadh	अंगाध		अनगढ़
angarh	अंगारह		अनगढ़
anchahe	अंचाहे		अनचाहे
anthak	अंथक		अनथक
unthak	ऊंठक		अनथक
anhoni	अन्होनिया		अनहोनी
anaavashyak	अनावश्यक		अनावश्यक
anavashyak	अनावश्यक		अनावश्यक
anavshyak	आन्वश्यक		अनावश्यक
anawashyak	अनावश्यक		अनावश्यक
anik	अनिका		अनिक
anishwarvadi	आनिश्वरवादी		अनीश्वरवादी
anishwarwadi	आनिश्वरवादी		अनीश्वरवादी
anukoltha	अनुकोलथ		अनुकूलता
anukulata	अनुकूलता		अनुकूलता
anukulta	अनुकूलता		अनुकूलता
anuchit	अनुचित		अनुचित
anuprayogi	अनुप्रयोगी		अनुप्रयोगों
anuprayogon	अनुप्रयोगों		अनुप्रयोगों
anupryogon	अनुपर्योगों		अनुप्रयोगों
anureet	अनुरीत		अनुरीत
anurit	अनुरीत		अनुरीत
anuthi	अनुठी		अनूठी
anudit	अनुदित		अनूदित
anyaay	अन्याय		अन्याय
anyay	अन्याय		अन्याय
anyaya	अन्याय		अन्याय
apnani	अपनानी		अपनानी
aparivartanshali	अपरिवर्तनशाली		अपरिवर्तनशील
aparivartansheel	अपरिवर्तनशील		अपरिवर्तनशील
aparivartanshil	अपरिवर्तनशील		अपरिवर्तनशील
apariharya	अपरिहार्य		अपरिहार्य
aprihary	अप्रधार्य		अपरिहार्य
apriyary	अपरियार्य		अपरिहार्य
apavartit	अपवर्तित		अपवर्तित
apvartit	अपवर्तित		अपवर्तित
apvtrit	अप्तृत्रित		अपवर्तित
apaardarshi	अपरदर्शी		अपारदर्शी
apardarshi	अपरदर्शी		अपारदर्शी
afroj	अफ्रोज		अफरोज
afroz	अफ्रोज		अफरोज
africa	अफ्रिका		अफ्रीका
abbaasi	अब्बासी		अब्बासी
abbasi	अब्बासी		अब्बासी
abhimat	अभिमत		अभिमत
abhishap	अभिषप		अभिशाप
abhi	अभी		अभी
amjhera	अमझेर		अमझेरा
amzera	अमजेरा		अमझेरा
amargad	अमरगद		अमरगढ़
amargarh	आमरगढ़		अमरगढ़
amarpaal	अमरपाल		अमरपाल
amarpal	अमरपाल		अमरपाल
amarohi	अमरोही		अमरोही
amrohi	अमरोही		अमरोही
amaanat	अमानत		अमानत
amanat	अमानता		अमानत
amanth	अमांत		अमानत
amaanati	अमानती		अमानती
amanathi	अमानाथी		अमानती
amanati	अमानती		अमानती
amavasya	अमावस्य		अमावस्या
amavsya	अमावस्य		अमावस्या
amit	अमिट		अमित
amitao	अमिताओं		अमिताव
amitav	अमितवा		अमिताव
amuk	अमुका		अमुक
amogh	अमोद		अमोघ
ambani	अंबानी		अम्बानी
ayodhyaanaath	अयोध्यान		अयोध्यानाथ
ayodhyanaath	आयोध्यनाथ		अयोध्यानाथ
ayodhyanath	आयोध्यनाथ		अयोध्यानाथ
ayodhyeanath	अयोध्यानित		अयोध्यानाथ
aradas	अरादास		अरदास
ardaas	आर्दास		अरदास
ardas	अर्दास		अरदास
arabab	अरबब		अरबाब
arbab	अरबब		अरबाब
around	अरूंद		अराउंड
arjent	अरजेंट		अर्जेंट
urgent	उर्गेंट		अर्जेंट
arth	आर्थ		अर्थ
artha	आर्थ		अर्थ
earth	ईर्थ		अर्थ
earthquake	इर्थकैक		अर्थक्वेक
arthon	अर्थों		अर्थों
arpit	अर्पित		अर्पित
aryama	आर्यम		अर्यमा
aryma	अर्यम		अर्यमा
arymaa	अर्यम		अर्यमा
alankaar	अलंकार		अलंकार
alankar	अलंकर		अलंकार
alnkaar	अलंकार		अलंकार
alankaaron	अलंकारों		अलंकारों
alankaron	अलंकारों		अलंकारों
alnkaaron	अलंकारों		अलंकारों
alnkaron	अलंकारों		अलंकारों
alagavavadi	आलगवादी		अलगाववादी
algavvadi	अल्गवादी		अलगाववादी
algavwaadi	अल्गवादी		अलगाववादी
alive	एलिव		अलाइव
alance	एलांस		अलायंस
alayans	अलायंस		अलायंस
aliance	एलियांस		अलायंस
alind	एलिंड		अलिंद
alai	अलाई		अली
ali	एली		अली
alii	आली		अली
alonso	एलोनो		अलोंसो
aloso	एलोसो		अलोंसो
alphabet	अलफबेट		अल्फ़ाबेट
alba	अलबा		अल्बा
avantipur	अवंतपुर		अवंतिपुर
awantipora	अवंटीपोर		अवंतिपुर
avaru	अवरू		अवरु
avru	अवरू		अवरु
awaru	आवारू		अवरु
avarodhak	आवरोधक		अवरोधक
avrodhak	अवरोधक		अवरोधक
avrodhk	आवरोधक		अवरोधक
avarnata	अवर्णनता		अवर्णता
avarnataa	अवर्णनता		अवर्णता
avranta	अवरंत		अवर्णता
avashist	अवशिष्ट		अवशिष्ट
avshisht	अवशिष्ट		अवशिष्ट
awashist	अवशिष्ट		अवशिष्ट
avasthaayen	अवस्थाएं		अवस्थाएं
avsthaen	अवस्थाएं		अवस्थाएं
avsthayen	अवस्थाएं		अवस्थाएं
awasthaen	अवस्थाएं		अवस्थाएं
avi	अएवी		अवि
avika	अविक		अविका
aviral	एविराल		अविरल
avirl	एवर्ल		अविरल
avishvaasniy	अविश्वासनीय		अविश्वसनीय
avishvasniy	अविश्वासनीय		अविश्वसनीय
avishvasniya	अविश्वासनीय		अविश्वसनीय
avisvasniya	अविश्वासनीय		अविश्वसनीय
aviva	अविव		अवीवा
avaigyanic	अवैज्ञानिक		अवैज्ञानिक
avaigyanik	अवैज्ञानिक		अवैज्ञानिक
avegyanik	आवेज्ञानिक		अवैज्ञानिक
ashaktataa	अशक्तता		अशक्तता
ashktta	अष्कता		अशक्तता
asharaphi	अशरफी		अशरफी
ashrafi	अश्वफी		अशरफी
ashariri	आशारीरी		अशरीरी
ashriri	अश्रीरी		अशरीरी
ashrvatath	अश्रवत		अश्वत्थ
ashvtth	अश्वत्थ		अश्वत्थ
asamaany	असमान्य		असमान्य
asamany	असामान्य		असमान्य
asmanye	असमान्य		असमान्य
asaamnjsy	असामंज्सी		असामंजस्य
asamanjasy	असमंजस्य		असामंजस्य
asamanjasya	असमंजस्य		असामंजस्य
asurakshit	असुरक्षित		असुरक्षित
asurkshit	असुरक्षित		असुरक्षित
aset	असेत		असेट
asset	एसेट		असेट
asvabhavik	अस्वाभाविक		अस्वभाविक
aswabhavik	अस्वाभाविक		अस्वभाविक
aswbhavik	अस्वभाविका		अस्वभाविक
ahirauli	अहिरौली		अहिरौली
item	आइटेम		आइटम
items	इटेम्स		आइटम्स
idle	आईडल		आइडल
idol	आईडल		आइडल
icc	आईसीसी		आइसीसी
iso	आईएसओ		आइसो
ipc	आईपीसी		आईपीसी
ipad	ईपाद		आईपैड
iris	आइरिस		आईरिस
ounce	आउंस		आउंस
aakaash	आकाश		आकाश
aakash	आकाश		आकाश
aake	आके		आके
aakhet	आखेत		आखेट
akhet	अखेतता		आखेट
aagat	आगत		आगत
aagaman	आगमान		आगमन
aagman	आजमान		आगमन
aagaa	आगा		आग़ा
aagah	आगाह		आग़ा
agha	आग		आग़ा
aagaashe	आगाशे		आगाशे
aagashe	आगशे		आगाशे
agashe	अगाशे		आगाशे
aajmaanaa	आजमान		आजमाना
aajmana	आजमान		आजमाना
aazmaanaa	आजमान		आजमाना
aata	आता		आटा
ata	अता		आटा
atta	आत्र		आटा
aatmayen	आत्मयें		आत्माएं
atmaen	आत्मेन		आत्माएं
aadaan	आदान		आदान
aadan	आदन		आदान
aadhaarit	आधारित		आधारित
aadharit	आधारित		आधारित
adharit	आधारित		आधारित
aadheen	आधीन		आधीन
aadhin	आधिन		आधीन
aadhunik	आधुनिक		आधुनिक
aanad	आनद		आनद
aanand	आनंद		आनद
anand	आनंद		आनद
aapka	आपक		आपका
aapkaa	आपक		आपका
aapadaaaen	आपदाएं		आपदाएं
aapdaein	आपदाईं		आपदाएं
aapdayein	आपदाएं		आपदाएं
aabantit	आबांतित		आबंटित
abantit	अबांतित		आबंटित
aabru	अब्रु		आबरू
abaru	एबारू		आबरू
aamdan	आमदन		आमदन
amadan	अमदान		आमदन
aamdani	आमदानी		आमदनी
amadani	अमादनी		आमदनी
aamdi	आमदी		आमदी
amdi	आमडी		आमदी
aamod	आमोद		आमोद
amod	अमोद		आमोद
aayenge	आएंगे		आयेंगे
aayojak	आयोजक		आयोजक
ro	रो		आरओ
rp	आरपीएप		आरपी
aaraam	आराम		आराम
aaram	आरम		आराम
aram	आरम		आराम
aarushi	आरुषि		आरुषि
arushi	अरुषि		आरुषि
artery	आर्टेरी		आर्टरी
order	ऑर्डर		आर्डर
aary	आर्य		आर्य
aarya	आर्य		आर्य
arya	आर्य		आर्य
aaryika	आर्यिक		आर्यिका
aryika	अर्यिक		आर्यिका
aarya	आर्य		आर्यो
arya	आर्य		आर्यो
aryo	अर्यो		आर्यो
aaryan	आर्यान		आर्यों
arya	आर्य		आर्यों
aryon	अर्यों		आर्यों
aalsi	आलसी		आलसी
alasi	आलसी		आलसी
aalochak	आलोचक		आलोचक
alochak	आलोचक		आलोचक
aalochakon	आलोचकों		आलोचकों
alochakon	आलोचकों		आलोचकों
aalha	आल्हा		आल्हा
aalhaa	आल्हा		आल्हा
alha	अल्ह		आल्हा
allah	अल्लाह		आल्हा
aawaazen	आवाजें		आवाज़ें
aawajen	आवाजें		आवाज़ें
awaazen	आवाजें		आवाज़ें
awazen	आवाजें		आवाज़ें
aawajon	आवाजों		आवाज़ों
aawazon	आवाजों		आवाज़ों
awaazon	आवाजों		आवाज़ों
awazon	आवाजों		आवाज़ों
aavishakaar	आविष्कार		आविष्कार
aavishkaar	आविष्कार		आविष्कार
avishkar	अविष्कार		आविष्कार
aavriti	आवृति		आवृत्ति
aavritti	आवृत्ति		आवृत्ति
avuti	आवयति		आवृत्ति
aavritiyon	आवृतियों		आवृत्तियों
aavrittiyon	आवृत्तियों		आवृत्तियों
avrutiyon	अवरूतियों		आवृत्तियों
aashanka	आशंक		आशंका
ashanka	अशंक		आशंका
aashriton	आश्रितों		आश्रितों
ashriton	अश्रीतों		आश्रितों
aasaan	आसान		आसान
aasan	आसन		आसान
asan	असन		आसान
aastik	आस्तिक		आस्तिक
astik	अस्तिक		आस्तिक
aasteen	आस्तिन		आस्तीन
aastin	आस्तिन		आस्तीन
astin	एस्टिन		आस्तीन
aahnaan	आहनान		आह्नान
aahnan	आहनन		आह्नान
ahyan	आह्वान		आह्नान
england	इंग्लैड		इंग्लैंड
engineer	इंजीनियर		इंजिनियर
introduction	इंट्रोडक्शन		इंट्रोडक्शन
insurance	इंसुरांस		इंश्योरेंस
ear	इयर		इअर
eyer	आईयर		इअर
eon	इयोन		इआन
iaan	इयान		इआन
ekattha	इकठ्ठा		इकट्ठा
ikattha	इकठ्ठा		इकट्ठा
ekatthi	इकट्ठी		इकठ्ठी
ekthi	इक्ठी		इकठ्ठी
ikatthi	इकट्ठी		इकठ्ठी
ekaee	इकाई		इकाई
ikai	ईकाई		इकाई
ekaeyon	इकाइयों		इकाईयों
ikaiyon	ईकाईयों		इकाईयों
ikarion	इकारियों		इकाईयों
economic	इकोनॉमिक		इकोनोमिक
ecuador	एक्यूडोल		इक्वाडोर
equador	एक्याडोर		इक्वाडोर
equities	इक्विटीज		इक्विटीज
ikvitija	इक्वितीज		इक्विटीज
ijaajat	इजाज़त		इजाजत
ijajat	इजाज़त		इजाजत
inhalation	इन्हेलेशन		इनहेलेशन
inhaletion	इन्हेलेशन		इनहेलेशन
ibija	इबीज़		इबीजा
ibiza	इबीज़		इबीजा
imaging	आइमेजिंग		इमेजिंग
immune	इम्यून		इम्युन
elaichi	इलाईचिया		इलाइची
ilaichi	इलाईचिया		इलाइची
ilayachi	इलायाची		इलाइची
ilayichi	इलायची		इलाइची
elaaj	इलाज		इलाज
ilaaj	इलाज़		इलाज
ilaj	इलाज़		इलाज
ishaak	इशाक		इशाक
ishaaq	इशाक		इशाक
ishak	इसहाक		इशाक
ishaara	इशार		इशारा
ishaaraa	इशार		इशारा
ishara	इशार		इशारा
ishita	इशीत		इशिता
isht	ईष्ट		इष्ट
isteefe	इस्तीफे		इस्तीफे
istife	इस्टीफ		इस्तीफे
ea	इ		ईए
ia	इए		ईए
eater	ईटर		ईटर
iter	इंटर		ईटर
email	इमैल		ईमेल
emailon	ईमाइलों		ईमेलों
emelon	एमिलोन		ईमेलों
evening	एवेनिंग		ईवनिंग
east	ईस्ट		ईष्ट
ishat	ईश्ट		ईष्ट
isht	ईष्ट		ईष्ट
isaaiyon	ईसाईयों		ईसाइयों
isaiyon	ईसाईयों		ईसाइयों
isayiyon	ईसाईयों		ईसाइयों
ikhrul	इखरूल		उखरुल
ukhrool	उखरूल		उखरुल
ukhrul	उखरूला		उखरुल
uchhalane	उछालने		उछालने
uchhalne	उछालने		उछालने
ujback	उज्बैक		उज़्बेक
uzbek	उज़्बेक		उज़्बेक
uthane	उठाने		उठने
uthne	उठने		उठने
uthaakar	उठाकर		उठाकर
uthakar	उठाकर		उठाकर
uthaapatak	उठापातक		उठापटक
uthapatak	उठापतक		उठापटक
uthen	उठाएं		उठें
udaan	उदान		उड़ान
udan	उड़ना		उड़ान
udaanaa	उदान		उड़ाना
udana	उड़ना		उड़ाना
udaane	उड़ाने		उड़ाने
udane	उड़ने		उड़ाने
udaanen	उदानें		उड़ानें
udanen	उड़नें		उड़ानें
udaanon	उदानों		उड़ानों
udanon	उदानों		उड़ानों
utane	उताने		उतने
utaney	उतने		उतने
utne	उतने		उतने
uttara	उत्तर		उत्तरा
uttra	उत्तर		उत्तरा
utpan	उत्पन		उत्पन
udant	उड़नता		उदंत
udghosh	उद्घोष		उदघोष
udar	उदार		उदर
uda	उड़ा		उदा
udaa	उड़ा		उदा
udakishuganj	उदाकिशुगंज		उदाकिशुनगंज
udakishunganj	उदाकिशुंगंज		उदाकिशुनगंज
unatees	उनातीस		उनतीस
untees	उन्तीज		उनतीस
uniyal	उनियाल		उनियाल
upadraviyon	उपद्रवियों		उपद्रवियों
updravion	उप्राव्यिजन		उपद्रवियों
updraviyon	उपद्रवियों		उपद्रवियों
upadravi	उपाद्रवी		उपद्रवी
updravi	उपद्रवी		उपद्रवी
upadrawon	उपाद्रवों		उपद्रवों
updravon	उपद्रवों		उपद्रवों
upneta	उपनेता		उपनेता
upabhokta	उपभोक्त		उपभोक्ता
upbhokta	उपभोक्त		उपभोक्ता
uplaksh	उपलक्ष		उपलक्ष्य
uplakshay	उपलक्षय		उपलक्ष्य
uplakshya	उपलक्ष्य		उपलक्ष्य
uplabdh	उपलब्ध		उपलब्ध
uplabdhiyon	उपलब्धियों		उपलब्धियों
uplabdhi	उपलब्धी		उपलब्धी
upakhyaanon	उपख्यानों		उपाख्यानों
upakhyanon	उपख्यानों		उपाख्यानों
ubuntu	उबूंतु		उबंटू
ubaal	उबाल		उबाल
ubal	उबला		उबाल
ubhaara	उभार		उभारा
ubhara	उभर		उभारा
umanath	उमनाथ		उमानाथ
umesh	उम्मेश		उमेश
urf	उर्फ		उर्फ
urfa	उर्फ		उर्फ
urff	उरफ		उर्फ
urvarakon	उर्वारकों		उर्वरकों
urvarkon	उर्वारकों		उर्वरकों
urwarakon	उर्वारकों		उर्वरकों
urvarata	उर्वारत		उर्वरता
urvarta	उरवर्त		उर्वरता
urwarta	उरवार्त		उर्वरता
ulate	उलते		उलटे
ulte	उल्टे		उलटे
ulahana	उलहना		उलाहना
ulahna	उलाहना		उलाहना
ulema	उल्लेम		उलेमा
ulemaon	उल्लेमॉओं		उलेमाओं
usak	उसका		उसक
usaki	उसकी		उसकी
uski	उसकी		उसकी
usmein	उसमें		उसमें
usmen	उसमें		उसमें
usi	उसी		उसी
ustara	उस्तार		उस्तरा
udharv	उधरवा		ऊर्ध्व
udhrva	उद्धृ		ऊर्ध्व
urdhav	उर्धव		ऊर्ध्व
ushma	उष्म		ऊष्मा
rishicool	रिशिकूल		ऋषिकुल
rishikul	ऋषिकुल		ऋषिकुल
rushikul	ऋषिकूल		ऋषिकुल
enzyme	इंजिम		एंजाइम
anton	एंटन		एंटोन
entone	एंटोन		एंटोन
antoni	अंटोनी		एंटोनी
antony	एंटोनी		एंटोनी
endometrial	इंडोमेट्रियल		एंडोमेट्रियल
andreas	एंड्रेस		एंड्रियास
als	एल्स		एएलएस
asi	एशिया		एएसआई
eksaath	इक्साथ		एकसाथ
eksath	इक्सता		एकसाथ
ekaki	एकाकी		एकाकी
xm	एक्सएम		एक्सएम
egmor	एजमोर		एगमोर
egmore	एजमौर		एगमोर
aj	आजा		एजे
agende	एजेंडे		एजेंडे
adp	एडीपी		एडीपी
adain	अदाइन		एडेन
aden	आड़े		एडेन
edan	ईडन		एडेन
addi	आदि		एड्डी
eddi	एडी		एड्डी
eddie	इडी		एड्डी
eddy	एडी		एड्डी
apj	अपजा		एपीजे
ftii	फ्ती		एफटीआईआई
abbott	अब्बोट		एबट
abut	अबूट		एबट
ebt	ईबीटी		एबट
abvp	एबीपीपी		एबीवीपी
abbot	अब्बोट		एबोट
abbott	अब्बोट		एबोट
mta	एमटीए		एमटीए
mtake	मटके		एमटेक
mtec	एमआईटीसी		एमटेक
mtech	माक्छ		एमटेक
emerald	इमरल्ड		एमरल्ड
emrald	इमराल्ड		एमरल्ड
emil	एमिल		एमिल
emile	इमीले		एमिल
emily	इमिली		एमिल
amy	आम्या		एमी
emi	इमी		एमी
airway	एयरवे		एयरवे
eyarave	एयरवे		एयरवे
eyarve	एयरवे		एयरवे
error	एर्रोर		एरर
arica	आरिक		एरिका
erica	एरिक		एरिका
erika	एरिक		एरिका
aerobic	एयरोबिक		एरोबिक
aerobics	एयरबिक्स		एरोबिक
lte	लटे		एलटीई
lti	लटी		एलटीई
allergic	एलर्जिक		एलर्जिक
eliminator	एलिमिनेटर		एलिमिनेटर
aliens	ऑलिंस		एलियंस
alliance	एलायंस		एलियंस
asian	एशियाई		एशियन
sfc	एसीसी		एसएफसी
sk	एसीके		एसके
spf	सीपीएफ		एसपीएफ
association	एसोसिएशन		एसोसिएशन
astar	अस्तर		एस्टर
aster	एस्टर		एस्टर
ester	ईस्टर		एस्टर
aesthetics	एस्थेटिक्स		एस्थेटिक
asthetic	अस्थेतिक		एस्थेटिक
asfalt	असलालता		एस्फाल्ट
asphalt	अस्फलता		एस्फाल्ट
asphault	असफहुल्ट		एस्फाल्ट
ahsaas	आहसास		एहसास
ehsaas	एहसास		एहसास
ehsas	एहसास		एहसास
aisa	ऐसा		एेसा
eesa	ईस		एेसा
ainth	ऐंठ		ऐंठ
end	ऐंड		ऐंठ
enth	इंथ		ऐंठ
ainthey	ऐंथे		ऐंठे
enthe	इंथे		ऐंठे
aithan	ऐंठन		ऐठन
ethan	ऐंठन		ऐठन
ethhan	ईंठन		ऐठन
ail	एला		ऐल
el	एला		ऐल
alaps	अल्प्स		ऐल्प्स
alps	अल्प्स		ऐल्प्स
aise	ऐस		ऐसे
oxide	ऑक्सीड		ऑक्साइड
oxy	ऑक्सी		ऑक्सी
offers	ऑफर्स		ऑफर्स
offshor	ऑफोशर		ऑफशोर
offshore	ऑफोसोर		ऑफशोर
official	ऑफिसल		ऑफिशियल
okalahoma	ओकलहों		ओकलाहोमा
oklahoma	ओकलहों		ओकलाहोमा
oklahoma	ओकलहों		ओक्लाहोमा
ot	ओटीए		ओत
opel	ओपल		ओपेल
obrayan	ओब्रायन		ओब्रायन
obrien	ओबरीन		ओब्रायन
oran	ओरन		ओरण
orian	ओरियाना		ओरियन
orion	ऑरियन		ओरियन
olavrishti	ओलावृष्टि		ओलावृष्टि
ovum	ओवुम		ओवम
owem	ओवम		ओवम
oceanic	ऑसिनिक		ओशनिक
osaka	ओसक		ओसाका
auchity	ऑचिटी		औचित्य
auchitya	ऑचिटी		औचित्य
audhyogikaran	औध्योगिकरण		औद्योगिकरण
audyogikarana	औध्योगिकरण		औद्योगिकरण
audyogikikaran	औध्योगिकीकरण		औद्योगिकरण
aurangabad	औरंगबद		औरंगाबाद
aurora	औरोर		औरोरा
aulakh	औलखा		औलख
kankad	कांकड़ा		कंकड़
kankar	कनकर		कंकड़
kankad	कांकड़ा		कंकर
kankar	कनकर		कंकर
kangan	कंगना		कंगन
conjunction	कन्ज्यूनक्शन		कंजंक्शन
contemporary	कंटेंपरीरी		कंटेम्पररी
kanthahar	कंठहर		कंठहार
kanthhar	कंठर		कंठहार
composer	कंपोसर		कंपोजर
kambalon	कांबलों		कंबलों
kanblon	कांबलों		कंबलों
consultant	कंसलटेंट		कंसलटेंट
kakkad	कक्कड़		कक्कड़
kakkar	कक्कर		कक्कड़
kacche	कच्छे		कच्चे
kachche	कच्चे		कच्चे
karta	करता		कटरा
katra	कत्र		कटरा
cutlery	कटलरी		कटलरी
katlari	कतलरी		कटलरी
katlary	कैटलरी		कटलरी
katasaraj	कतासराज		कटासराज
kathfodave	कथफोड़वे		कठफोड़वे
kathfodve	कथफोड़वे		कठफोड़वे
kathor	कठोर		कठोर
kathore	कठोरे		कठोर
kanika	कानिक		कणिका
kathai	कथाई		कत्थई
katthai	कट्ठाई		कत्थई
katthaii	कट्ठाई		कत्थई
convention	कन्वेशन		कनवेंशन
canals	कैनल्स		कनाल
kanaal	कनाल		कनाल
kanal	कनाल		कनाल
kanindham	कनिंदम		कनिंघम
kaningham	कनिंघम		कनिंघम
kanishthika	कन्यष्ठिक		कनिष्ठिका
kanishthikaa	कन्यष्ठिक		कनिष्ठिका
kanishtika	कनिष्टिक		कनिष्ठिका
kanyaayen	कन्याएं		कन्याएं
kanyaein	कन्याएं		कन्याएं
kanyayen	कन्याएं		कन्याएं
convention	कन्वेशन		कन्वेंशन
convocation	कन्वास्कैशन		कन्वोकेशन
cup	कप		कप
kap	कप		कप
kapda	कपड़		कपड़ा
kpada	कपड़		कपड़ा
kapdo	कपड़ो		कपड़ो
kapdon	कपड़ों		कपड़ो
kaping	कापिंग		कपिंग
kping	क्पिंग		कपिंग
kapolkalpana	कपोलकाल्पन		कपोलकल्पना
kabaddi	कबाद्दी		कबड्डी
kabr	काबरा		कब्र
kabra	काबरा		कब्र
kabren	कब्रेन		कब्रें
kabron	कब्रों		कब्रों
kamjor	कमजोर		कमज़ोर
kamzor	कमजोर		कमज़ोर
kamatar	कमातर		कमतर
kamtar	कामतार		कमतर
kalamjeet	कलमजीत		कमलजीत
kamaljeet	कमलजीत		कमलजीत
kamaauu	कमाऊ		कमाऊ
kamau	कमाऊ		कमाऊ
kamaate	कमाते		कमाते
kamate	कमते		कमाते
kamere	कमेरे		कमेरे
kmere	कमेरे		कमेरे
karanj	करंज		करंज
kranj	क्रंज		करंज
karanjiya	करणजीय		करंजिया
kardhe	कर्धे		करघे
karghe	करघे		करघे
karachana	कराचना		करछना
karchhana	कर्च्छन		करछना
karna	कर्ण		करना
karpatri	कर्पतरी		करपात्री
karam	करमा		करम
karoor	करुर		करूर
karur	करुर		करूर
karnataka	कर्णनता		कर्नाटका
karvi	करवी		कर्वी
kurvi	कुरवी		कर्वी
kalmein	कलमें		कलमें
kalmen	कालमें		कलमें
kalraj	कलराज		कलराज
kalika	कालिका		कलिका
kalpanaon	कल्पनाओं		कल्पनाओं
kalpnaon	कल्पनाओं		कल्पनाओं
kavvaliyon	काववालियों		कव्वालियों
qawwaliyon	क्ववालियों		कव्वालियों
kavvali	क़व्वाली		कव्वाली
qawwali	क्ववाली		कव्वाली
kashton	काष्टों		कष्टों
kasarat	कसरता		कसरत
kasrat	कासरता		कसरत
kasara	कसर		कसारा
kasida	कसीद		कसीदा
kahane	कहाने		कहने
kahne	कहने		कहने
kahlaya	कहलाया		कहलाया
kahaniyon	कहानियों		कहानियों
kile	किले		क़िले
kanji	कांजी		कांजी
cant	केंट		कांट
kant	कांत		कांट
kanti	कांती		कांति
kakoo	काकू		काकू
kaku	काकू		काकू
kaagaj	कागज		कागज़
kaagaz	कागज		कागज़
kagaj	कागज		कागज़
kagaz	कागज		कागज़
kaaji	काजी		काजी
kaji	काजी		काजी
kazi	काजी		काजी
qazi	काजी		काजी
kajoo	काजू		काजू
kaju	काजू		काजू
kapadi	कपाड़ी		कापड़ी
kapdi	कपड़ी		कापड़ी
kamraj	कामराज		कामराज
kamottejana	कमोत्तेजन		कामोत्तेजना
kamottejna	कमोतेजन		कामोत्तेजना
kailana	कैलन		कायलाना
kaylana	कायलान		कायलाना
carfi	कैर्फी		कार्की
karki	कर्की		कार्की
kartik	कार्टिक		कार्तिक
karyakartaon	कार्यकर्ताओं		कार्यकर्ताओं
karykartaaon	कार्यकर्ताओं		कार्यकर्ताओं
karykartaon	कार्यकर्ताओं		कार्यकर्ताओं
karyabhar	कार्यभर		कार्यभार
karybhar	कार्यभर		कार्यभार
karyarat	कार्यारत		कार्यरत
karyrat	कार्यरता		कार्यरत
kaalpi	कालपी		कालपी
kalapi	कलापी		कालपी
kalpi	कल्पी		कालपी
kalika	कालिका		कालिका
kalighat	कलीघाट		कालीघाट
coldvel	कोल्डवल		काल्डवेल
kaldvel	काल्डवेल		काल्डवेल
kaldwell	काल्डवेल		काल्डवेल
kaav	कावा		काव
kav	कवा		काव
kaasht	काष्ठ		काश्त
kasht	काष्ठ		काश्त
kasim	कासिम		कासिम
qasim	कासिम		कासिम
kasimabad	कासिमाबड़		कासिमाबाद
kiya	किया		किया
kiliyan	कीलियान		किलियन
killat	किलैट		किल्लत
killi	किल्ली		किल्ली
kisaani	किसानी		किसानी
kisani	किसनी		किसानी
kisanon	किसनों		किसानों
keede	कीड़े		कीड़े
kide	कीड़े		कीड़े
keynote	कैनेट		कीनोट
kinote	किनोट		कीनोट
kiratpur	किरतपुर		कीरतपुर
kundal	कुंडल		कुंडल
kundaliya	कुंडलीय		कुंडलियाँ
kundaliyan	कुंडलियां		कुंडलियाँ
kutta	कुट्टा		कुत्ता
kuposhit	कुपोषित		कुपोषित
kumau	कुमाऊ		कुमाऊ
kumavat	कुमावट		कुमावत
kumawat	कुमावट		कुमावत
kural	कुराल		कुराल
kurmi	कुर्मी		कुर्मी
kursiyon	कुर्कियों		कुर्सियों
kush	कुशा		कुश
kushaan	कुशान		कुषाण
kushan	कुशान		कुषाण
kusumalataa	कुसुमलता		कुसुमलता
kusumalta	कुसुमलता		कुसुमलता
kusumlata	कुसुमलता		कुसुमलता
koot	कूट		कूट
kut	कुटा		कूट
kritika	कृतिक		कृतिका
kpo	केपो		केपीओ
canterbari	कैंटरबारी		कैंटरबरी
canterbury	कैंटरबरीरी		कैंटरबरी
candidate	कैंडिडेट		कैंडिडेट
katrina	कतरीन		कैटरीना
caitlyn	कैटलिन		कैटलिन
cateline	कैटेलिन		कैटलिन
catlin	कैटलिन		कैटलिन
cadmium	कैडमियम		कैडमियम
catholic	कैथलिक		कैथोलिक
catholicon	कैथलिकन		कैथोलिकों
kaetholikon	कैथोलिकों		कैथोलिकों
capacitor	कैपेक्टर		कैपेसिटर
carat	करात		कैरेट
cavity	कैविटी		कैविटी
cavalry	कैवल्री		कैवेलरी
kaivelari	काइवेलरी		कैवेलरी
complex	कम्प्लेक्स		कॉम्प्लेक्स
kocchi	कोची		कोच्चि
kochi	कोची		कोच्चि
corridor	कॉरिडोर		कोरिडोर
corolla	कोरोल		कोरोला
korola	कोरोल		कोरोला
caolan	कालन		कोलन
colan	कोलन		कोलन
colon	कालों		कोलन
calling	कैलिंग		कोलिंग
koling	कोलिंग		कोलिंग
colorado	कलर्डों		कोलोराडो
kolorado	कोलोरेडो		कोलोराडो
kaushal	कौशल		कौशल
kaushalata	कउशलता		कौशलता
kaushalta	कौशलता		कौशलता
kaushambi	कौषंबी		कौशाम्बी
cute	कूट		क्यूट
quete	क्वेट		क्यूट
cube	क्यूब		क्यूब
cubeck	कबेक		क्यूबेक
quebec	क्वेबैक		क्यूबेक
cubes	क्यूबैस		क्यूब्स
krantiyon	क्रंतियों		क्रांतियों
cric	सीआरसी		क्रिक
crick	क्रिक		क्रिक
cricket	क्रिकेट		क्रिकेट
cricketer	क्रिकटर		क्रिकेटर
cricketing	क्रिकटिंग		क्रिकेटिंग
kriyayog	क्रियायों		क्रियायोग
christian	क्रिश्चियन		क्रिश्चयन
kruger	क्रगेर		क्रूगर
craig	क्रैग		क्रेग
creg	क्रेग		क्रेग
cradle	क्रेडल		क्रैडल
chrom	क्रोम		क्रोम
chrome	करोम		क्रोम
client	क्लाइंट		क्लांइट
clock	क्लॉक		क्लाक
clasen	क्लेजन		क्लासें
classen	क्लासन		क्लासें
classon	क्लासन		क्लासों
clay	क्ले		क्ले
claris	क्लारिस		क्लेरिस
cleris	क्लीरिस		क्लेरिस
clerys	क्लर्स		क्लेरिस
quantico	क्वांटिक		क्वांटिको
queens	क्वींस		क्वींस
kshitij	क्षितीज		क्षितिज
shitij	शितिज		क्षितिज
kshin	क्षिण		क्षीण
shin	शीना		क्षीण
kshetron	क्षेत्रों		क्षेत्रों
shetron	शेटरों		क्षेत्रों
khand	खांद		खंडा
khanda	खांद		खंडा
khachakhach	खचाखच		खचाखच
khajarana	खजारन		खजराना
khajraana	खजरान		खजराना
khajrana	खजरान		खजराना
khatakati	खतकती		खटकती
khatakti	खतकती		खटकती
kihatkati	क्वातकति		खटकती
khattapan	खट्टापन		खट्टापन
khat	खाता		खत
khani	खानी		खनि
khanik	खानिक		खनिक
khanikarm	खानीकर्म		खनिकर्म
khanikarma	खानीकर्म		खनिकर्म
khanikarmi	खानीकर्मी		खनिकर्म
khapat	खपट		खपत
khariya	खरिया		खरिया
khalnayak	खालनायक		खलनायक
khaaskar	खासकर		ख़ासकर
khaskar	खासकर		ख़ासकर
khaastaur	खासतौर		ख़ासतौर
khastaur	खासतौर		ख़ासतौर
khaibar	खैबर		ख़ैबर
khyber	खैबर		ख़ैबर
khaein	खाएं		खाएं
khaen	खाएं		खाएं
khayen	खायें		खाएं
khaate	खाते		खाते
khaatey	खाते		खाते
khate	खाते		खाते
khal	खल		खाल
khinchakar	खिंचकर		खिंचकर
khinchkar	खिंचकर		खिंचकर
khilana	खिलना		खिलाना
khinchkar	खिंचकर		खींचकर
khuda	खुद		खुदा
khudai	खुदाई		खुदाई
khurapka	खुरापक		खुरपका
khurpaka	खुरपक		खुरपका
khurasan	खुरासन		खुरासान
khushiyan	खुशियां		खुशियां
khene	खेने		खेने
khaini	खैनी		खैनी
khairati	खैरती		खैराती
khoikhoi	खोईखो		खोईखोई
khoya	खोया		खोया
gangrel	गैंग्रेल		गंगरेल
gangaajal	गंगाजल		गंगाजल
gangajal	गंगजल		गंगाजल
gandaki	गंदाकी		गंडकी
gandki	गंदकी		गंडकी
gandh	गंध		गंध
gandha	गंध		गंध
gae	गाई		गए
gaye	गाये		गए
gajara	गाजर		गजरा
gajra	गजरा		गजरा
gadkar	गड़कर		गडकर
ganapati	गणपती		गणपति
ganpati	गणपती		गणपति
gatisheel	गतिशील		गतिशील
gatishil	गतिशील		गतिशील
gatishilata	गतिशीलता		गतिशीलता
gadadhar	गादधार		गदाधर
gammat	गम्मत		गम्मत
gaya	गे		गया
garibi	गारीबी		गरीबी
garjana	गरजन		गर्जना
galgand	गलगंड		गलगंड
gahmagahmi	गहमग्मु		गहमागहमी
gemhagehmi	गेमहाजितामी		गहमागहमी
ganguly	गंगुल्य		गांगुली
gaanth	गांठ		गांठ
ganth	गंठ		गांठ
gaanthe	गांठे		गांठे
ganthe	गंठे		गांठे
ganthen	गंतहें		गांठें
ganthon	गंथों		गांठों
gaen	गायें		गाएं
gayen	गायें		गाएं
gazi	गाजी		गाज़ी
gajipur	गाजीपुर		गाजीपुर
gazipur	गाज़ीपुर		गाजीपुर
gayatri	गयात्री		गायत्री
gayitri	गायित्री		गायत्री
gaytri	गयत्री		गायत्री
gidgidate	गिद्दीड़े		गिड़गिड़ाते
ginate	गिनते		गिनते
ginte	गिनते		गिनते
girkar	गिरकर		गिरकर
girijaghar	गिरिजाघर		गिरजाघर
girjaghar	गिरजाघर		गिरजाघर
girijagharon	गिरिजाघरों		गिरजाघरों
girjagharon	गिरजाघारों		गिरजाघरों
girati	गिराती		गिरती
girti	गिरती		गिरती
girish	गिरिश		गिरीश
guan	गुना		गुआन
gujar	गुजरा		गुजार
gujarata	गुजरात		गुजारता
gujarta	गुजरता		गुजारता
gujarate	गुजराते		गुजारते
gujarte	गुजरते		गुजारते
gujarana	गुजरन		गुजारना
gujarna	गुजरना		गुजारना
gujara	गुजरा		गुजारा
gujare	गुजरे		गुजारे
gutta	गुट्टा		गुट्टा
gthalidar	गुतलीदार		गुठलीदार
guthalidar	गुथलीदार		गुठलीदार
gudna	गुड़ना		गुदना
gumaan	गुमान		गुमान
guman	गुमान		गुमान
gulshan	गुलशन		गुलशन
gunga	गुंग		गूंगा
grihnagar	गृहनगर		गृहनगर
gruhnagar	घृहनगर		गृहनगर
galaxion	गैलक्शियों		गैलेक्सियों
galaxiyon	गलक्षियों		गैलेक्सियों
galaxyon	गैलक्सियों		गैलेक्सियों
gochar	गोचर		गोचर
gouchar	गौचर		गोचर
godara	गोदर		गोदारा
gopichand	गोपीचंद		गोपीचंद
gomake	गोमाके		गोमके
gomke	गोम्क		गोमके
goel	गोल		गोयल
goyal	गोयल		गोयल
gosvaami	गोस्वामी		गोस्वामी
gosvami	गोसवामी		गोस्वामी
goswami	गोस्वामी		गोस्वामी
gaumukh	गौमुख		गौमुख
gomukh	गोमुख		गौमुख
gaumutr	गौमुत्र		गौमूत्र
gaumutra	गौमुत्र		गौमूत्र
gowmutra	गोममुत्र		गौमूत्र
granthiyaan	ग्रंथियां		ग्रंथियां
granthiyan	ग्रंथियां		ग्रंथियां
grandhiyon	गृणधियों		ग्रंथियों
granthiyon	ग्रंथियों		ग्रंथियों
greest	ग्रीस्ट		ग्रीस्ट
greist	ग्रेज्ट		ग्रीस्ट
grist	ग्रीस्ट		ग्रीस्ट
greg	ग्रेग		ग्रेग
granite	ग्रेनीट		ग्रेनाइट
grenite	ग्रैनीज		ग्रेनाइट
grandson	ग्रैंडसन		ग्रैंडसन
gross	ग्रोस		ग्रॉस
ghataatop	घटातोप		घटाटोप
ghatatop	घटतोप		घटाटोप
ghataayaa	घटाया		घटाया
ghataya	घटाया		घटाया
ghanakar	घनाकर		घनाकार
ghabrahat	घबराहट		घबराहट
ghasi	घासी		घासी
ghisai	घिसाई		घिसाई
ghisi	घिसी		घिसी
ghise	घीसे		घिसे
ghumakkadi	घुमक्कड़ी		घुमक्कड़ी
ghumakkdi	घूमकुकड़ी		घुमक्कड़ी
ghumakkadon	घुमक्कड़ों		घुमक्कड़ों
ghumakkaron	घुमक्करों		घुमक्कड़ों
ghumakkdon	घुमक्कड़ों		घुमक्कड़ों
ghummakkadon	घुम्मकादड़ों		घुमक्कड़ों
ghumaan	घुमान		घुमाण
ghuman	घूमना		घुमाण
ghoonsa	घूंस		घूंसा
ghunsa	घुंस		घूंसा
ghongha	घोंघा		घोंघा
ghontane	घोंटने		घोंटने
ghontne	घोंटने		घोंटने
ghot	घोटा		घोट
ghodi	घोड़ी		घोड़ी
ghost	घोस्ट		घोस्ट
changul	चंगुल		चंगुल
chand	चांद		चंद
chandan	चंदन		चंदन
chandana	चंदन		चंदन
chandu	चंदुआ		चंदू
chandon	चांडों		चंदों
chandrabali	चंद्रबाली		चंद्रबली
chandramaon	चंद्रमाओं		चंद्रमाओं
chakatte	चकत्ते		चकत्ते
chaktte	चकत्ते		चकत्ते
chakkar	चक्कर		चक्कर
chkkar	चक्कर		चक्कर
chakshu	चक्षु		चक्षु
chatagaon	चटागांव		चटगांव
chatgaon	चतगांव		चटगांव
chadhane	चढ़ने		चढ़ने
chadhne	चढ़ने		चढ़ने
chaturdik	चतुर्दीक		चतुर्दिक
chatunshkoniy	चतुंशकों		चतुष्कोणीय
chatushkoniy	चतुष्कों		चतुष्कोणीय
chatushkoniya	चतुष्कों		चतुष्कोणीय
channa	चन्ना		चन्ना
chabate	चबाते		चबाते
chabutare	चाबूतरे		चबूतरे
chabutre	चाबूतरे		चबूतरे
chamakna	चमकना		चमकना
chamkana	चमकना		चमकना
charas	चरस		चरस
charit	चरित		चरित
charcha	चर्च		चर्चा
churcha	चर्च		चर्चा
charchaon	चर्चाओं		चर्चाओं
chalenge	चलेंगे		चलेंगे
chlenge	च्लेंज		चलेंगे
chahunaur	चाहनौर		चहुंओर
chahunor	चाहनूर		चहुंओर
chanval	चनवाल		चांवल
chanwal	चांवला		चांवल
chachaji	चचजी		चाचाजी
chadar	चादर		चादर
chadaron	चड़ारों		चादरों
chadron	चड्रों		चादरों
chan	चाना		चान
chanan	चनना		चानन
chaplusi	चैपलुसी		चापलूसी
chayal	चयाल		चायल
char	चर		चार
charon	चारों		चारों
charge	चार्ज		चार्ज
chart	चरता		चार्ट
charton	चार्टन		चार्टों
charts	चार्ट्स		चार्ट्स
chaalit	चालित		चालित
chalit	चलित		चालित
chikitsak	चिकित्सक		चिकित्सक
chikitsakon	चिकित्सकों		चिकित्सकों
chikhali	चिखली		चिखली
chiththi	चित्ती		चिट्ठी
chitthi	चिट्ठी		चिट्ठी
chithhi	चित्ही		चिठ्ठी
chiththi	चित्ती		चिठ्ठी
chitthi	चिट्ठी		चिठ्ठी
chidchidapan	चिड़चिड़ापन		चिडचिडापन
chidchidapan	चिड़चिड़ापन		चिड़चिड़ापन
chidhate	चिड़ते		चिढ़ते
chidhte	चिड़ते		चिढ़ते
chithrkar	चित्रकर		चित्रकार
chitrkar	चित्रकार		चित्रकार
chipakane	चिपकने		चिपकने
chipakne	चिपकने		चिपकने
chipkane	चिपकने		चिपकने
chimati	चिमटी		चिमटी
chimti	चिमटी		चिमटी
chillane	चिल्लाने		चिल्लाने
chee	ची		ची
chi	ची		ची
chuka	चूका		चुका
chune	चुने		चुने
chunar	चुनार		चूनर
changed	चंगेद		चेंज्ड
chetti	चेतती		चेट्टी
chennai	चेनने		चेन्नई
chero	चेरो		चेरो
chest	चेस्ट		चेस्ट
championship	चमपियंशिप		चैंपियनशिप
chor	चोर		चोर
choro	चोरो		चोरों
choron	चोरों		चोरों
chauk	चौका		चौक
chowk	चोवा		चौक
chauka	चौका		चौका
chuka	चूका		चौका
chaukiyan	चौकियां		चौकियां
chauki	चौकी		चौकी
chaukhate	चौखते		चौखटे
chauguni	चौगुनी		चौगुनी
chauda	चौड़ा		चौड़ा
chaudah	चौदह		चौड़ा
chaudahavan	चौदहवान		चौदहवां
chaudhavan	चौधवान		चौदहवां
chaudhawan	चौदहवां		चौदहवां
chaupati	चौपती		चौपाटी
chupaty	चुपत्या		चौपाटी
chaupal	चौपाल		चौपाल
chaurai	चौराई		चौरई
chausinga	चौसिंग		चौसिंगा
chausingha	चौषिंह		चौसिंगा
chhagan	छागना		छगन
chhabi	छाबी		छबि
chhalla	छल्ला		छल्ला
chhallaa	छल्ला		छल्ला
chhaviyaan	छवियाँ		छवियाँ
chhaviyan	छवियां		छवियाँ
chhavi	छावी		छवी
cheh	चेह		छह
chhah	छाह		छह
chehon	चेहों		छहों
chhahon	छाहों		छहों
chhai	छाई		छाई
chhagla	छग्ला		छागला
chhajan	छजन		छाजन
chhaati	छाती		छाती
chhati	छटी		छाती
chhaapemaar	छापीमार		छापेमार
chhapemar	छापेमार		छापेमार
chheenk	छींका		छींक
chhink	छींका		छींक
chink	चिंका		छींक
chenkein	चेंकें		छींके
chhekein	छेकें		छींके
chhinke	छींके		छींके
chhinky	चींकी		छींके
chinke	चिंके		छींके
chhudaane	छुड़ाने		छुडाने
chhudane	छुड़ाने		छुडाने
chhupakar	छुपाकर		छुपकर
chhupkar	छुपकर		छुपकर
chhupkr	छुपक्र		छुपकर
chhupata	छुपात		छुपता
chhupta	छुप्ता		छुपता
chhuptaa	छुप्ता		छुपता
chhura	छुड़ा		छुरा
chhuraa	छुड़ा		छुरा
chhuree	छुड़ी		छुरी
chhuri	छुड़ी		छुरी
chhure	छुड़े		छुरे
chhootane	छूटने		छूटने
chhutane	छुट्टाने		छूटने
chhutne	छुट्टने		छूटने
chheter	छेटर		छेत्र
chhetr	छेत्र		छेत्र
chhetter	छेटर		छेत्र
chhetri	छेतरी		छेत्री
chhetthari	छेत्थरी		छेत्री
chhetthri	छेत्थरी		छेत्री
chai	चाय		छै
chhai	छाई		छै
chhe	छे		छै
jagaega	जगाएगा		जगाएगा
jagayega	जगाएगा		जगाएगा
jaghaega	जगहाग		जगाएगा
jgaayega	जगाएगा		जगाएगा
jgayegaa	जगाएगा		जगाएगा
jajaon	जजाओं		जजों
jajon	जाजों		जजों
jad	जड़ा		जड़
jadd	जद्दा		जड़
jaddit	जद्दित		जड़ित
jadeite	जादेत		जड़ित
jadet	जदेत		जड़ित
jadit	जड़ीता		जड़ित
jadein	जड़ें		जड़ें
jaden	जदें		जड़ें
jatara	जतारा		जतरा
jatra	जातरा		जतरा
jataati	जताती		जताती
jatatee	जताती		जताती
jatati	जताती		जताती
janagananaa	जनागन्नन		जनगणना
janaganna	जनागन्न		जनगणना
jangadnaa	जांगड़ना		जनगणना
janganana	जंगानन		जनगणना
janganna	जांगन्न		जनगणना
janajagran	जनाजग्रण		जनजागरण
janjaagran	जनजाग्रण		जनजागरण
janjagran	जनजाग्रण		जनजागरण
january	जनुर्य		जनवरी
janahaani	जनाहानी		जनहानि
janahani	जनाहणी		जनहानि
janhaani	जनहानी		जनहानि
janhani	जनहानी		जनहानि
jnhaani	जनहानी		जनहानि
jamaate	जमाते		जमाती
jamaati	जमाती		जमाती
jamati	जमती		जमाती
jamaaya	जमाया		जमाया
jamaeya	जमाया		जमाया
jamaya	जमाया		जमाया
jamayaa	जमाया		जमाया
jamuai	जमुआई		जमुई
jamuei	जमुए		जमुई
jamui	जमूई		जमुई
jai	जई		जय
jay	जाय		जय
jaidayal	जयदायल		जयदयाल
jayadayal	जयदायल		जयदयाल
jaydayal	जयदायल		जयदयाल
jaibaan	जयबान		जयबाण
jaiban	जयबन		जयबाण
jaybaan	जयबान		जयबाण
jayalalita	जयललित		जयललिता
jayalalitaa	जयललित		जयललिता
jayalalithaa	जयलालीत		जयललिता
jaylalita	जयलालित		जयललिता
jarakh	जरख		जरख
zarakh	जरख		जरख
jarda	जर्द		जर्दा
jardaa	जर्द		जर्दा
zarda	जर्द		जर्दा
jalagati	जलागति		जलगति
jalgati	जलगती		जलगति
jalgti	जलगती		जलगति
jalte	जलते		जलते
jalbharav	जलभराव		जलभराव
jalbhraav	जलभराव		जलभराव
jalbhrav	जलभर्व		जलभराव
jalvaayu	जलवायु		जलवायु
jalvayu	जलवायु		जलवायु
jalesar	जलेशर		जलेसर
jasmeet	जस्मीत		जसमीत
jasmit	जस्मिता		जसमीत
jassee	जस्सी		जस्सी
jassi	जस्सी		जस्सी
jamaanaa	जमाना		ज़माना
jamana	जमाना		ज़माना
zamaanaa	जमाना		ज़माना
zamana	जमाना		ज़माना
jaljale	जलजले		ज़लज़ले
zalzale	जलजले		ज़लज़ले
zee	जि		ज़ी
jubaan	जुबान		ज़ुबान
juban	जुबान		ज़ुबान
zuban	जुबान		ज़ुबान
jaanch	जांच		जाँच
jaaunch	जौंचा		जाँच
janch	जांच		जाँच
jaunch	जौंचा		जाँच
jaagriti	जाग्रीति		जागृति
jagriti	जगरीती		जागृति
jagruti	जगरूती		जागृति
jajamau	जजमाऊ		जाजमऊ
jajmau	जजमाऊ		जाजमऊ
jajmauu	जजमाऊ		जाजमऊ
jaat	जाता		जात
jat	जटा		जात
jaatak	जाटक		जातक
jatak	जतक		जातक
jaatakon	जाटकों		जातकों
jaatkon	जाटकों		जातकों
jatakon	जटकों		जातकों
jaatiyon	जातियों		जातियों
jatiyon	जातियों		जातियों
jaankaaron	जानकारों		जानकारों
jaankaron	जानकरों		जानकारों
jankaron	जानकरों		जानकारों
jaanam	जानम		जानम
janam	जन्मम		जानम
jaayke	जायके		जायके
jayke	जायके		जायके
jaawar	जावर		जावर
zawar	जवार		जावर
jing	जिंग		जिंग
gin	गिना		जिन
jeen	जीण		जिन
jin	जीना		जिन
ginee	गिनी		जिनी
jinee	जिनी		जिनी
jini	जिनी		जिनी
geneva	जिनेवा		जिनीवा
jeneva	जेनेवा		जिनीवा
jiniva	जिनीव		जिनीवा
gypsy	जिप्सी		जिप्सी
jimme	जिम्मे		जिम्मे
jiya	जिया		जिया
gic	जीईसी		जीआईसी
gr	ग्रा		जीआर
gm	जीएमए		जीएम
gsm	जीएसएम		जीएसएम
gtod	ग्टोड		जीतोड़
gtor	ग्टोर		जीतोड़
jeetod	जीतोड़		जीतोड़
jitod	जितोड़		जीतोड़
jean	जेना		जीन
jeen	जीण		जीन
jin	जीना		जीन
jeenon	जीनों		जीनों
jinon	जीनों		जीनों
jeepney	जीपनय		जीपनी
jipani	जिपनी		जीपनी
jeeyo	जीयो		जीयो
jio	जिओ		जीयो
jiyo	जियो		जीयो
jeera	जीर		जीरा
jira	जीर		जीरा
jeevant	जीवंत		जीवंत
jivant	जीवंत		जीवंत
jeevan	जीवन		जीवन
jeewan	जीवन		जीवन
jivan	जीवन		जीवन
jiwan	जीवन		जीवन
jeevanshaili	जीवनशैली		जीवनशैली
jivanshaili	जीवनशैली		जीवनशैली
jeevniyaan	जीवनियां		जीवनियां
jivaniya	जीवनीय		जीवनियां
jivaniyaan	जीवनियां		जीवनियां
jivaniyan	जीवनियां		जीवनियां
jeevraaj	जीवराज		जीवराज
jivraj	जीवराज		जीवराज
jua	जू		जुए
jue	जुए		जुए
juye	जुए		जुए
jutee	जुटी		जुटी
juti	जूती		जुटी
judaai	जुड़ाई		जुड़ाई
judae	जुड़ाए		जुड़ाई
judai	जुड़ाई		जुड़ाई
judaai	जुड़ाई		जुदाई
judai	जुड़ाई		जुदाई
junoon	जुनून		जुनून
junun	जुनुना		जुनून
junooni	जुनूनी		जुनूनी
jununi	जुनुनी		जुनूनी
jubair	ज़ुबैर		जुबेर
juber	ज़ुबैर		जुबेर
zubair	ज़ुबैर		जुबेर
juraab	जुराब		जुराब
jurab	जुराब		जुराब
julaahon	जुलाहों		जुलाहों
julahon	जुलाहों		जुलाहों
julmon	जुल्मों		जुल्मों
zulmon	जुल्मों		जुल्मों
jood	जूद		जूड
jud	जुदा		जूड
junagadh	जूनागढ़		जूनागढ
junagarh	जूनागढ़		जूनागढ
junior	जुनीयर		जूनियर
jealous	जील्स		जूलूस
juloos	जुलूस		जूलूस
julus	जुलूस		जूलूस
jetha	जेठ		जेठा
jenner	जेनर		जेनर
generic	जेनेरिक		जेनरिक
jenrick	जेनरिक		जेनरिक
generat	जनरेट		जेनरेट
generate	जनरेट		जेनरेट
jenee	जिनी		जेनी
jenni	जेनी		जेनी
jenny	जेनी		जेनी
james	जम्स		जेम्स
jeremy	जेरेमी		जेरेमी
gerome	जिरोम		जेरोम
jerome	जेरोम		जेरोम
jacks	जैक्स		जैक्स
jain	जैं		जैन
gene	जेन		जैने
jaine	जैने		जैने
jaino	जैं		जैनों
jainon	जैंनों		जैनों
jerry	जेरी		जैरी
jasper	जसपर		जैस्पर
jogging	जोगिंग		जॉगिंग
johnson	जानसन		जॉनसन
jobs	जोब्स		जॉब्स
jockey	जॉके		जोकि
joki	जोकी		जोकि
jokhim	जोखीम		जोखिम
joddta	जोड़ता		जोड़ता
jodta	जोडता		जोड़ता
jorhta	जोडता		जोड़ता
jodiyon	जोड़ियों		जोड़ियों
jodo	जोडो		जोड़ो
jaun	जौन		जौं
gyatavya	ज्ञातव्य		ज्ञातव्य
gyatvy	ज्ञातव्य		ज्ञातव्य
gyapit	ज्ञापित		ज्ञापित
jyotiba	ज्योतिब		ज्योतिबा
joint	जॉइंट		ज्वाइंट
jvar	जवर		ज्वार
jwar	ज्वर		ज्वार
jvaaron	जवारों		ज्वारों
jvaron	जवरों		ज्वारों
jwaron	जवरों		ज्वारों
jewellers	ज्वेलर्स		ज्वेलर्स
jh	झा		झ
jha	झा		झ
jhalakti	झलकती		झलकती
jhalkati	झलकती		झलकती
jhalla	झल्ला		झल्ला
jhankana	झांकना		झांकना
jhankna	झंकना		झांकना
jheel	झील		झील
jhil	झीला		झील
jheelon	झीलों		झीलों
jhilon	झीलों		झीलों
jhuthala	झूठला		झुठला
jhuthla	झूथला		झुठला
jhuthalane	झूठलने		झुठलाने
jhuthlane	झुठलने		झुठलाने
tankaar	टंकार		टंकार
tankar	टैंकर		टंकार
takara	ताकर		टकरा
takra	टाकर		टकरा
takaraon	टकराओं		टकरावों
takravon	तकरावों		टकरावों
tapakti	तपकती		टपकती
tapkati	तपकती		टपकती
time	टाइम		टाइम
timer	टाइमर		टाइमर
taoo	टाउ		टाऊ
tau	ताऊ		टाऊ
tapoowo	तपूवो		टापुओं
tapuon	तापुओं		टापुओं
tapuwo	तपुरो		टापुओं
tied	तिड़		टायर्ड
tired	तिराद		टायर्ड
tyred	तायर्ड		टायर्ड
tarch	तर्च		टार्च
torch	टॉर्च		टार्च
tik	टिका		टिक
teap	टीप		टिप
tip	टीप		टिप
tippanikar	तिप्पनिकार		टिप्पणीकार
tippnikar	टिप्पणिकार		टिप्पणीकार
tivolee	तिवाली		टिवोली
tivoli	तिवाली		टिवोली
teekamgarh	तीकमगढ़		टीकमगढ़
tikamgarh	तीकमगढ़		टीकमगढ़
teekon	टीकों		टीकों
tikon	टीकों		टीकों
two	टू		टु
tension	टेंसन		टेंशन
tenis	टेनिस		टेनिस
tennis	टेंसिस		टेनिस
taste	तासते		टेस्ट
test	टेस्ट		टेस्ट
tasting	टास्टिंग		टेस्टिंग
testing	टेस्टिंग		टेस्टिंग
tainin	टैनिन		टैनिन
tenin	टेनिन		टैनिन
tanish	तनिश		टैनिस
tennis	टेंसिस		टैनिस
taboo	तबू		टैबू
taiboo	तैबू		टैबू
taobao	तादाओ		टैबू
tonic	टोनिक		टॉनिक
tonga	तोंग		टोंगा
toka	टॉक		टोका
tuesday	तुसदे		ट्यूजडे
tuning	ट्यूनिंग		ट्यूनिंग
tuberculosis	ट्यबर्कुलिस		ट्यूबरक्यूलोसिस
tuberkyulosis	ट्यबर्कियलोसिस		ट्यूबरक्यूलोसिस
truck	ट्रक		ट्रक
trangistor	ट्रांजिस्टर		ट्रांजिस्टर
tranjister	ट्रांजिस्टर		ट्रांजिस्टर
transistor	ट्रांसिस्टर		ट्रांजिस्टर
transfer	ट्रैंफर		ट्रान्सफर
tribunal	ट्रिबुनल		ट्रिब्युनल
tribunal	ट्रिबुनल		ट्रिब्यूनल
trubyunal	ट्रिब्यूनल		ट्रिब्यूनल
truth	तृथ		ट्रुथ
tuth	तूथ		ट्रुथ
traded	ट्रेड		ट्रेडेड
trabal	त्रेबला		ट्रेबल
trebal	त्रेबल		ट्रेबल
trouble	ट्रबल		ट्रेबल
traip	ट्रैप		ट्रैप
trap	ट्रेप		ट्रैप
trot	ट्रोत		ट्रॉट
trott	ट्रॉट		ट्रॉट
thakkar	ठक्कर		ठक्कर
thakkr	ठक्कर		ठक्कर
thaharne	ठहरने		ठहरने
thahrane	ठहराने		ठहरने
theharne	ठहरने		ठहरने
thikane	ठिकाने		ठिकाने
thumari	थुमारी		ठुमरी
thumri	थुमरी		ठुमरी
theinga	ठेंग		ठेंगा
thenga	ठेंग		ठेंगा
thengaa	ठेंग		ठेंगा
daglas	डेग्लास		डगलस
douglas	डॉगलास		डगलस
dabhara	दाभार		डभरा
dabhra	दाभरा		डभरा
dabhoi	दभाई		डभोई
dam	दम		डम
dum	दुम		डम
darate	डरते		डराते
daratey	डरते		डराते
daravani	दरावनी		डरावनी
darawani	दरावनी		डरावनी
dravani	द्रवानी		डरावनी
down	दाउन		डाउन
daak	डाक		डाक
dak	डक		डाक
daka	डक		डाका
dabi	दबी		डाबी
dabolim	डाबोलियम		डाबोलिम
dinosaur	दिनोसौर		डायनासोर
diaries	डायरीज		डायरीज
dit	डीटा		डिट
depthiriya	डिप्थिरिया		डिप्थीरिया
diphtheria	दीप्तहरी		डिप्थीरिया
de	डीईए		डीई
dealership	डिलर्शिप		डीलरशिप
dvc	डीएवसी		डीवीसी
dubaana	दुबान		डुबाना
dubana	दूबना		डुबाना
dubona	डूबों		डुबोना
dulne	दुलने		डुलने
doonarpur	दूनरपुर		डूंगरपुर
doongarpur	दुंगरपुर		डूंगरपुर
dungarpur	दुंगरपुर		डूंगरपुर
dungerpur	दुंगरपुर		डूंगरपुर
dubana	दूबना		डूबना
dubna	डूबना		डूबना
dangerous	डेंजरूस		डेंजरस
daisy	दैस्य		डेजी
dazy	दज्य		डेजी
deji	देजी		डेजी
deputy	डिप्टी		डेप्युटी
davidson	दविद्सों		डेविडसन
devidson	डेविड्सन		डेविडसन
davey	डेव		डेवी
devi	देवी		डेवी
dewey	डेवे		डेवी
destination	डिस्टिनेशन		डेस्टिनेशन
datson	दत्सों		डैटसन
datsun	दत्सुन		डैटसन
daddy	दद्दाय		डैडी
dark	डार्क		डॉर्क
dork	डोर्क		डॉर्क
dose	डोस		डोज
domenic	डोमेनिका		डोमेनिक
doranda	डोरंड		डोरंडा
dolane	डोलने		डोलने
dolne	डोलने		डोलने
dual	डुएल		ड्युअल
duak	डुक		ड्यूक
duke	डूके		ड्यूक
drame	ड्रेम		ड्रामे
dramen	ड्रमैन		ड्रामे
drager	ड्रेजर		ड्रेजर
dredger	ड्रेजर		ड्रेजर
dreijer	ड्रैजर		ड्रेजर
dhakaal	ढकाल		ढकाल
dhakal	ढकल		ढकाल
dhakkal	ढक्कल		ढकाल
dhkal	ढकाल		ढकाल
dhale	ढाले		ढले
dhoondh	धूंध		ढूंढ
dhundh	धुंध		ढूंढ
dhoondhata	धूंधता		ढूंढता
dhundhata	धुंधता		ढूंढता
dhundhta	धुंधता		ढूंढता
dhoondhi	धूंधी		ढूंढी
dhundhi	धुंधी		ढूंढी
tanjavur	तंजावूर		तंजावुर
thanjavur	तंजावूर		तंजावुर
tantr	तांत्र		तंत्र
tantra	तांत्र		तंत्र
tantrikao	तांत्रिकों		तंत्रिकाओं
tantrikaon	तंत्रिकाओं		तंत्रिकाओं
tantro	तंत्रों		तंत्रों
tantron	तंत्रों		तंत्रों
tagade	तगड़े		तगड़े
tagde	तगड़े		तगड़े
tadipaar	तादीपार		तड़ीपार
tadipar	तादीपर		तड़ीपार
tani	तानी		तनी
tapan	तपन		तपन
tarafa	तराफ		तरफा
tarfa	तरफा		तरफा
tarabganj	तरबगंज		तरबगंज
taras	तारस		तरस
taraash	ताराश		तराश
tarash	ताराश		तराश
tarashay	ताराशय		तराशे
tarashe	तराशे		तराशे
tareeko	तारीकों		तरीको
tariko	तारीकों		तरीको
tark	तर्क		तर्क
tarkvaad	तर्कवाद		तर्कवाद
tarkvad	तर्कवाद		तर्कवाद
tarkwaad	तर्कवाद		तर्कवाद
tarko	टर्को		तर्कों
tarkon	टर्कों		तर्कों
talabgaar	तलबगार		तलबगार
talabgar	तलबगार		तलबगार
talbagaar	तलबागार		तलबगार
talbagar	तलबागड़		तलबगार
talawe	तलावे		तलवे
talve	तलवे		तलवे
talawon	तलावों		तलवों
talvon	तलवों		तलवों
tahakhana	तहखाना		तहखाना
tahkhaana	तहखान		तहखाना
tahkhana	तहखाना		तहखाना
taantaa	टांट		तांता
tanta	टांट		तांता
tambe	तांबे		तांबे
tanbe	टांबे		तांबे
taaja	ताज		ताजा
taajaa	ताज		ताजा
taaza	ताज		ताजा
taja	ताज		ताजा
taza	ताज		ताजा
tansen	टांसेन		तानसेन
taapmaanon	तापमानों		तापमानों
tapmano	तापमानों		तापमानों
tapmanon	तपमानों		तापमानों
taapti	तापति		ताप्ती
tapti	तप्ति		ताप्ती
tarabai	तरबाई		ताराबाई
taseer	तसीर		तासीर
tasir	तासीर		तासीर
taahi	ताही		ताहि
tahi	ताही		ताहि
tikone	टिकोन		तिकोने
tirupati	तिरुपति		तिरूपति
tiwari	तिवाड़ी		तिवारी
ti	ति		ती
teer	तीर		तीर
tir	तीरा		तीर
teeron	तीरों		तीरों
tiron	तीरों		तीरों
tirthatan	तीर्थटन		तीर्थाटन
tungnath	तूंगनाथ		तुंगनाथ
tughlaq	तुथलाक		तुगलक
tuglak	तुग्लक		तुगलक
tughlakabad	तुथलाकाबड़		तुगलकाबाद
tughlaqabad	तुथलाकाबाद		तुगलकाबाद
tuglakabad	तुगलाकाबाद		तुगलकाबाद
tugalaki	तुगुलकी		तुगलकी
tugalki	तुगालकी		तुगलकी
tuglaki	तुग्लकी		तुगलकी
tufail	तूफ़ैल		तुफैल
tejaji	तेजजी		तेजाजी
teji	तेज़ी		तेजी
tel	टेल		तेल
telon	टेलों		तेलों
to	तो		तो
toh	तोह		तो
taul	तौला		तौल
tyohaar	त्योहार		त्यौहार
tyohar	त्योहार		त्यौहार
tyoihar	त्यौहार		त्यौहार
tyauharon	त्याहारों		त्यौहारों
tyoharon	त्योहारों		त्यौहारों
tyoiharon	त्यौहारों		त्यौहारों
trijata	त्रिजता		त्रिजटा
trijta	तृजता		त्रिजटा
triya	त्रिया		त्रिया
tremasik	ट्रैमासिक		त्रैमासिक
trimasik	त्रिमासिक		त्रैमासिक
tse	ते		त्से
thaki	थकी		थकी
thki	थकी		थकी
tharti	थर्टी		थर्टी
thirty	थिर्टी		थर्टी
thane	ठाणे		थाणे
thaanvi	ठांवी		थानवी
thanvi	ठांवी		थानवी
theateron	थीटरों		थिएटरों
theatron	थीतरों		थिएटरों
theaters	थीटर्स		थिएटर्स
theater	थीटर		थियेटर
theatre	थिअरे		थियेटर
theateron	थीटरों		थियेटरों
theatron	थीतरों		थियेटरों
thitron	थितरों		थियेटरों
theaters	थीटर्स		थियेटर्स
theatrs	थीटर्स		थियेटर्स
thiyeters	थीयर्सर्स		थियेटर्स
thirake	थिराके		थिरके
thirke	थिरके		थिरके
thief	थीफ़		थीफ
then	थें		थेन
theni	ठेनी		थेनी
thailee	ठैली		थैली
thaili	थाइली		थैली
thaile	ठैले		थैले
dang	डैंग		दंग
danga	डैंग		दंगा
dangon	दंगों		दंगों
dampati	डामपति		दंपति
danpati	डांपती		दंपति
dampatiyon	दंपतियों		दंपतियों
dampattiyon	दंपत्तियों		दंपतियों
danptiyon	दंपतियों		दंपतियों
dadreva	दद्रेव		ददरेवा
dadrewa	दद्रेव		ददरेवा
damoh	दमोह		दमोह
dardara	दरदार		दरदरा
dardraa	दरद्र		दरदरा
durdhara	दूरदार		दरदरा
darmiyaan	दरमियां		दरमियान
darmiyan	दरमियान		दरमियान
darjano	दर्जनों		दर्जनों
darjanon	दर्जनों		दर्जनों
darp	डीआरपीएप		दर्प
darra	डर		दर्रा
dalbadal	दलबदल		दलबदल
dalbadl	दलबदला		दलबदल
dali	दली		दली
dastaanaa	दस्ताना		दस्ताना
dastana	दस्ताना		दस्ताना
dastavej	दस्तावेज़		दस्तावेज
dahan	दहना		दहन
dahal	डाहल		दहल
da	डीडी		दा
daakhil	दाखिल		दाखिल
dakhil	दाखिला		दाखिल
daakhile	दाखिले		दाखिले
dakhile	दखीले		दाखिले
daataa	दाता		दाता
data	डाटा		दाता
dadari	दादरी		दादरी
daanshil	दांशील		दानशील
danshil	दंशील		दानशील
daabholkar	दाभोलकर		दाभोलकर
dabholkar	दाभोलकर		दाभोलकर
damale	डमले		दामले
damle	दमले		दामले
dayitv	दायित्व		दायित्व
dayitva	दायित्व		दायित्व
dayitwa	दायित्व		दायित्व
dayitvon	दायित्वों		दायित्वों
dayityon	दायित्यों		दायित्वों
darul	दारुल		दारूल
daav	दावा		दाव
daaw	दावा		दाव
dav	दवा		दाव
daw	दवा		दाव
daah	दाह		दाह
dah	दहा		दाह
dikhla	दिखला		दिखला
dikhlaa	दिखला		दिखला
dikhaaiye	दिखाइए		दिखाइये
dikhaiye	दिखाइए		दिखाइये
dikhaai	दिखाई		दिखाई
dikhai	दिखाई		दिखाई
dikhayi	दिखाई		दिखाई
dikhaaee	दिखाए		दिखाईं
dikhaai	दिखाई		दिखाईं
dikhaain	दिखाइना		दिखाईं
dikhaee	दिखाई		दिखाईं
dikhai	दिखाई		दिखाईं
dikhayin	दिखाइना		दिखाईं
dikhai	दिखाई		दिखायी
dikhayi	दिखाई		दिखायी
dikhaai	दिखाई		दिखार्इ
dikhae	दिखाए		दिखार्इ
dikhai	दिखाई		दिखार्इ
dikhayi	दिखाई		दिखार्इ
dita	डीटा		दिता
ditaa	डीटा		दिता
dinaank	दिनांक		दिनांक
dinank	डीनका		दिनांक
dirham	दीरहम		दिरहम
dilaaye	दिलाए		दिलाये
dilaye	दिलाए		दिलाये
deewani	दीवानी		दिवानी
diwani	दीवानी		दिवानी
divy	दिव्य		दिव्य
divya	दिव्य		दिव्य
divyata	दीव्यता		दिव्यता
divya	दिव्य		दिव्या
deepan	दीपन		दीपन
deepn	दीप्न		दीपन
dipan	दीपन		दीपन
deepsingh	दीप्सिंह		दीपसिंह
dipsingh	दीपसिंह		दीपसिंह
deepika	दीपिक		दीपिका
dipika	दीपिक		दीपिका
deeya	दीय		दीया
diya	दिया		दीया
dukaanon	दुकानों		दुकानों
dukanon	दुकानों		दुकानों
dukke	डूके		दुक्के
dukhan	दुखाना		दुखन
dukhit	दुखित		दुखित
dukhiyon	दुखियों		दुखियों
dukhon	दूखों		दुखों
dubhashiyon	दुभाषियों		दुभाषियों
durgun	दुर्गुन		दुर्गुण
durghatna	दुर्घटना		दुर्घटना
durghtna	दूर्घतना		दुर्घटना
duneerti	दुनीरती		दुर्नीति
durniti	दूर्णति		दुर्नीति
durbhiksh	दूरभीक्षा		दुर्भिक्ष
duvidhaaen	दुविधाएं		दुविधाएं
duvidhaayein	दुविधाएं		दुविधाएं
duvidhaen	दुविधाएं		दुविधाएं
duwaidhaayein	दुवैधाएं		दुविधाएं
dune	डूने		दूने
doordarshan	दूरदर्शन		दूरदर्शन
durdarshan	दूरदर्शन		दूरदर्शन
dradh	दृद्ध		दृढ़
dridh	धृध		दृढ़
dekhoge	देखोगे		देखोगे
denevaali	देनेवाली		देनेवाली
denevali	देनेवाली		देनेवाली
denewaali	देनेवाली		देनेवाली
denewali	देनेवाली		देनेवाली
deonar	डेयनर		देवनार
devnaar	देवनार		देवनार
devnar	देवनार		देवनार
devaapur	देवापुर		देवापुर
devapur	देवपुर		देवापुर
devi	देवी		देवी
devisingh	देविसिंह		देवीसिंह
devisinh	देविसिंह		देवीसिंह
deshkaal	देशकाल		देशकाल
deshkal	देशकाल		देशकाल
deshke	देशके		देशके
desai	देसई		देसाई
doge	डोगे		दोगे
dvadash	द्वादशा		द्वादश
dwaadas	द्वादस		द्वादश
dvivedi	द्विवेदी		द्विवेदी
dwivedi	द्विवेदी		द्विवेदी
dhande	धंडे		धंधे
dhandhe	धंधे		धंधे
dhndhe	ढंढे		धंधे
dhandhon	धंधों		धंधों
dhandon	धांडों		धंधों
dhakelte	ढकेलते		धकेलते
dhkelate	ढकेलते		धकेलते
dhatana	ढातना		धटना
dhatna	ढाटना		धटना
dhankuber	धानकुबर		धनकुबेर
dhanadhany	धनाधन्य		धनधान्य
dhandhaanya	धांधन्य		धनधान्य
dhandhany	धांधन्य		धनधान्य
dhandhanya	धांधन्य		धनधान्य
dhamkaataa	धमकाता		धमकाता
dhamkata	धमकता		धमकाता
dhamm	धम्मा		धम्म
dhamma	धम्मा		धम्मा
dhammaa	धम्मा		धम्मा
dharmnath	धर्मनाथ		धर्मनाथ
dharmraj	धर्मृत		धर्मराज
dharmesh	धर्मेश		धर्मेश
dhasmaanaa	धस्मान		धस्माना
dhasmana	धासमन		धस्माना
dhaak	ढाका		धाक
dhak	ढका		धाक
dhaaga	ढागा		धागा
dhaagaa	ढागा		धागा
dhaga	ढागा		धागा
dhaatuein	धातुएं		धातुएं
dhaatuyein	धातुएं		धातुएं
dhtuen	धुतुओं		धातुएं
dhaarak	धारक		धारक
dharak	धारक		धारक
dhaari	धारी		धारी
dhari	धारी		धारी
dhuan	धुंआ		धुआं
dhunaai	धुनाई		धुनाई
dhunai	धुनाई		धुनाई
dhuriya	धुरिया		धुरिया
dhuriyaa	धुरिया		धुरिया
dhuni	धूणी		धूनी
dhairyavaan	धैर्यवान		धैर्यवान
dhairyawan	धैर्यवान		धैर्यवान
dhiryavan	धीरयवान		धैर्यवान
dhiryawaan	धीरयवान		धैर्यवान
dhokebaaj	धोखेबाज		धोखेबाज
dhokebaaz	धोखेबाज		धोखेबाज
dhokebaj	धोखेबाज		धोखेबाज
dhokebaz	धोखेबाज		धोखेबाज
dhokhebaaj	धोखेबाज		धोखेबाज
dhokhebaj	धोखेबाज		धोखेबाज
dhona	धों		धोना
dhonaa	धों		धोना
dhoraaji	धोराजी		धोराजी
dhoraji	धोराजी		धोराजी
dhoron	धोरों		धोरों
dhyeyavaadi	ध्यावादी		ध्येयवादी
dhyeywadi	ध्यावादी		ध्येयवादी
dyeyvadi	द्यायवादी		ध्येयवादी
dhrupad	ध्रुपदा		ध्रुपद
drupad	द्रुपद		ध्रुपद
nandanvan	नंदनवान		नंदनवन
nadsa	नाद्स		नक्सल
naksal	नक्सल		नक्सल
naxal	नंकल		नक्सल
naksalavaad	नकसलावाद		नक्सलवाद
naksalwaad	नकसलवाद		नक्सलवाद
naksalwad	नक्सलवाद		नक्सलवाद
naxalvaaad	नकलवाद		नक्सलवाद
naxalwaad	नकलवाद		नक्सलवाद
naksaliyon	नकसलियों		नक्सलियों
naxaliyon	नंकलियों		नक्सलियों
naksali	नकसली		नक्सली
naxali	नाकली		नक्सली
nagaada	नागाद		नगाड़ा
nagaadaa	नागाद		नगाड़ा
nagaaraa	नागार		नगाड़ा
nageene	नागीने		नगीने
nagine	नागिन		नगीने
najarandaaj	नज़रंदाज़		नजरंदाज
najarandaaz	नज़रंदाज़		नजरंदाज
nazarandaaj	नज़रंदाज़		नजरंदाज
nazarandaaz	नज़रंदाज़		नजरंदाज
nazarandaz	नज़रंदाज़		नजरंदाज
najraane	नज़राने		नजराने
nazraane	नज़राने		नजराने
najariyon	नज़रियों		नजरियों
najriyon	नज़रियों		नजरियों
najron	नजरों		नजरों
najeeb	नजीब		नजीब
najib	नाजीब		नजीब
najibabaad	नाजीबाद		नजीबाबाद
najibabad	नाजीबाबाद		नजीबाबाद
najeem	नाजिम		नजीम
najim	नाजिम		नजीम
nazeem	नजीम		नजीम
nana	नाना		नना
nanaa	नाना		नना
nna	ना		नना
nanhe	नन्हे		नन्हें
nanhein	नन्हें		नन्हें
nabj	नब्ज		नब्ज़
nabja	नब्ज		नब्ज़
nabz	नब्ज		नब्ज़
namkeen	नमकीन		नमकीन
namkin	नमकीन		नमकीन
narnaari	नर्नारी		नरनारी
narnari	नर्नरी		नरनारी
narbhakshi	नर्भक्षी		नरभक्षी
naram	नाराम		नरम
narm	नर्म		नरम
narmi	नर्मी		नरमी
narsanhar	नरसंहर		नरसंहार
narsanharon	नर्संहारों		नरसंहारों
november	नोवंबर		नवंबर
navketan	नवकेतन		नवकेतन
navjaagaran	नवजागरण		नवजागरण
navjagran	नवजागरण		नवजागरण
navdha	नवध		नवधा
navvadhoo	नववाधू		नववधू
navvadhu	नववादु		नववधू
nava	नाव		नवा
navaa	नाव		नवा
navate	नवाते		नवाते
navanagar	नवानगर		नवानगर
nawanagar	नवानगर		नवानगर
navya	नेवी		नव्या
naseem	नसीम		नसीम
nasim	नसीम		नसीम
nights	नाइट्स		नाइट्रस
nitrous	नाइट्रूस		नाइट्रस
nineteez	निनटीज		नाइनटीज
nineties	निनेटिज		नाइनटीज
ninties	निंटीज		नाइनटीज
nau	नाउ		नाऊ
nauu	नाऊ		नाऊ
naakaam	नाकाम		नाकाम
nakam	नकाम		नाकाम
naagrik	नागरिक		नागारिक
nagarik	नागरिक		नागारिक
nagrik	नागरिक		नागारिक
nagin	नागिन		नागिन
nadep	नाडेप		नाडेप
nanak	नानक		नानक
nanavati	नानावटी		नानावती
napane	नापने		नापने
napne	नपने		नापने
napa	नाप		नापा
naam	नाम		नाम
naamdhari	नामधारी		नामधारी
namdhari	नमधारी		नामधारी
namankano	नमांकनों		नामांकनों
namankanon	नमांकनों		नामांकनों
namavaliyon	नमावलियों		नामावलियों
naamo	नामो		नामो
namo	नमो		नामो
nayak	नायक		नायक
naraji	नाराजी		नाराजी
naraingarh	नारेंगढ़		नारायणगढ़
narayangadh	नारायंगढ़		नारायणगढ़
narayangarh	नारायंगढ़		नारायणगढ़
naasar	नासर		नासर
nahargadh	नहारगढ़		नाहरगढ
nahargarh	नहारगाढ़		नाहरगढ
nikalegi	निकलेगी		निकलेगी
nikalogi	निकलोगी		निकलेगी
nikaalani	निकालनी		निकालनी
nikaalni	निकालनी		निकालनी
nikalani	निकलनी		निकालनी
nikalni	निकलनी		निकालनी
nicki	निकी		निकी
nicky	निकी		निकी
niki	निकी		निकी
niketan	निकेतन		निकेतन
nikhar	निखर		निखर
nikhari	निखारी		निखरी
nigar	निगार		निगर
nigger	निगर		निगर
nichala	निचला		निचला
nichalaa	निचला		निचला
nichla	निचला		निचला
nitiyon	नीतियों		नितियों
nitya	नित्य		नित्या
nityaa	नित्य		नित्या
nidhaan	निधान		निधान
nidhan	निधन		निधान
nipatara	निपटार		निपटारा
niptaara	निपटार		निपटारा
niptaaraa	निपटार		निपटारा
niptara	निपटारा		निपटारा
niyanta	नियंत		नियंता
niyantaa	नियंत		नियंता
niya	निया		निया
niyaa	निया		निया
nirdeshika	निर्देशिक		निर्देशिका
nirdeshikaa	निर्देशिक		निर्देशिका
nirdhaarit	निर्धारित		निर्धारित
nirdharit	निर्धारित		निर्धारित
nirbaadh	निर्बाध		निर्बाध
nirbadh	निर्बध		निर्बाध
niveshakartaa	निवेदकर्ता		निवेशकर्ता
niveshkarta	निवेदकर्ता		निवेशकर्ता
niveshkartaa	निवेदकर्ता		निवेशकर्ता
nischal	निष्चल		निश्चल
nishchal	निष्चल		निश्चल
nishnaat	निष्नात		निष्णात
nishpaap	निष्पाप		निष्पाप
nihalaani	निहालानी		निहलानी
nihlaani	निहलानी		निहलानी
nihlani	निहलानी		निहलानी
nihaalchand	निहालचंद		निहालचंद
nihalchand	निहालचंद		निहालचंद
neechaaee	नीचाई		नीचाई
nichaai	निचाई		नीचाई
neat	नेट		नीट
neet	नीता		नीट
neetiyon	नीतियों		नीतियों
nitiyon	नीतियों		नीतियों
neelagaay	नीलगा		नीलगाय
nilgai	निलगई		नीलगाय
neelaabh	नीलाभ		नीलाभ
nilaabh	निलाभ		नीलाभ
nilabh	निलाभा		नीलाभ
nuskhe	नुस्खे		नुस्खे
noon	नून		नून
nun	नूना		नून
noobiyaa	नूबिया		नूबिया
nubiya	नुबिया		नूबिया
nrityashaili	नृत्यशेली		नृत्यशैली
nrutyashaili	नृत्यशेली		नृत्यशैली
nrityon	नृत्यों		नृत्यों
nrutyon	नृत्यों		नृत्यों
neco	नेको		नेको
neko	नेको		नेको
nectar	नेक्टर		नेक्टर
neg	नेग		नेग
nega	नेग		नेग
networking	नेटवर्किंग		नेटवर्किग
neto	नेटो		नेटो
neta	नेटा		नेता
nemo	नेमो		नेमो
nelsan	नेल्सन		नेल्सन
nelson	नेल्सन		नेल्सन
nations	नाइशंस		नेशंस
nehara	नेहर		नेहरा
nehra	नेहर		नेहरा
naino	नाइनों		नैनो
nano	नानो		नैनो
naivedh	नायवेद		नैवेद्य
naivegh	नाइवेघ		नैवेद्य
nevedya	नेवेद्य		नैवेद्य
nominate	नोमीनेट		नॉमिनेट
naukari	नौकरी		नोकरी
naukri	नौकरी		नोकरी
nokari	नोकरी		नोकरी
nokri	नोकरी		नोकरी
notes	नोटीस		नोट्स
nora	नोर		नोरा
nori	नोरी		नोरी
nauner	नौनर		नौनेर
nauvahan	नवहाहन		नौवहन
naushad	नौशद		नौशाद
panchaang	पंचांग		पंचांग
panchang	पंचांग		पंचांग
punchang	पंचांग		पंचांग
punjab	पंजब		पंजाब
punjabiyon	पुंजबियों		पंजाबियों
pantar	पंतर		पंटर
panter	पैंटर		पंटर
punter	पंटर		पंटर
pakaayein	पकाएं		पकाएं
pakaayen	पकाएं		पकाएं
pakaen	पकाएं		पकाएं
pakayen	पकाएं		पकाएं
pakaude	पकाउड़े		पकौड़े
pakshapat	पश्चापत		पक्षपात
pakshpaat	पक्षपात		पक्षपात
pakshpat	पक्षपता		पक्षपात
pagabadha	पगाबधा		पगबाधा
pagbadha	पग्गाध		पगबाधा
pagalaa	पागल		पगला
pagla	पगला		पगला
pachaataa	पचाता		पचाता
pachata	पचाता		पचाता
patakkar	पतक्कर		पटककर
patkathaayein	पटकथाएं		पटकथाएं
patkathaein	पटकथाएं		पटकथाएं
patkathayen	पटकथाएं		पटकथाएं
patki	पतकी		पटकी
pataraani	पतरानी		पटरानी
patrani	पत्रणी		पटरानी
patavaari	पटवारी		पटवारी
patwari	पटवारी		पटवारी
pataakshep	पैटक्शेप		पटाक्षेप
patachep	पताचेप		पटाक्षेप
patakshep	पैटक्षेप		पटाक्षेप
patiya	पटिया		पटिया
patiyaa	पटिया		पटिया
padaraunaa	पदारौण		पडरौना
padrauna	पद्रौण		पडरौना
padega	पड़ेगा		पड़ेगा
padegaa	पड़ेगा		पड़ेगा
padha	पढ़		पढ़ा
padhaa	पढ़		पढ़ा
padhaataa	पढ़ाता		पढ़ाता
padhata	पढ़ता		पढ़ाता
patili	पतीली		पतीली
padamawati	पद्मावती		पदमावती
padmavati	पद्मावती		पदमावती
padmawati	पद्मावती		पदमावती
padadhikari	पदाधिकारी		पदाधिकारी
panapnaa	पनपना		पनपना
panpana	पनपन		पनपना
panaamaa	पनाम		पनामा
panama	पन्म		पनामा
paneer	पनीर		पनीर
pammi	पाम्मी		पम्मी
pammu	पेममू		पम्मी
pummi	पुम्मी		पम्मी
pummy	प्यमी		पम्मी
pardesiyon	परदेशियों		परदेसियों
pardesi	पर्देशी		परदेसी
parva	पर्व		परवा
parvaa	पर्व		परवा
parwa	परवा		परवा
parwaa	परवा		परवा
paraadheen	पराधीन		पराधीन
paraadhin	पराधीन		पराधीन
paradheen	पराधीन		पराधीन
paradhin	पाराधीन		पराधीन
parikalpit	परीकल्पित		परिकल्पित
parimal	परिमाल		परिमल
parishad	परिशाद		परिषद
parishadiy	परिशादिया		परिषदीय
parishadiya	परिशादिया		परिषदीय
parishadon	परिशदों		परिषदों
parikhaen	परीक्षें		परीक्षाएं
parikshaayein	परीक्षाएं		परीक्षाएं
parikshaen	परीक्षाएं		परीक्षाएं
parosane	पैरोसन		परोसने
parosne	परोसने		परोसने
parda	परदा		पर्दा
pardaa	परदा		पर्दा
purple	पूर्पले		पर्पल
palatne	पलात्ने		पलटने
paltane	पल्टने		पलटने
palaari	पलारी		पलारी
palari	पलारी		पलारी
pale	पाले		पले
palmonari	पाल्मोनरी		पल्मोनरी
pulmonary	पुल्मोनरी		पल्मोनरी
plus	प्लस		पल्स
pulse	पुलसे		पल्स
pashtun	पश्चुन		पश्तून
pashtuun	पश्चुन		पश्तून
pahan	पहन		पहन
pehan	पहन		पहन
pahantaa	पहंत		पहनता
pahnata	पहनाता		पहनता
pehnate	पहनते		पहनता
pahanate	पहनते		पहनते
pahante	पहंते		पहनते
pehnate	पहनते		पहनते
pahnaakar	पहनाकर		पहनाकर
pahnakar	पहनाकर		पहनाकर
pehnakar	पहनाकर		पहनाकर
pahnaati	पहनती		पहनाती
pahnati	पहनती		पहनाती
pehnati	पहनती		पहनाती
pahani	पहनी		पहनी
pahni	पाहनी		पहनी
pehni	पहनी		पहनी
pahno	पहनो		पहनो
pehno	पहनो		पहनो
pahla	पहला		पहला
pahlaa	पहला		पहला
pehla	पहला		पहला
paheliyaan	पहेलियां		पहेलियां
paheliyan	पहेलियां		पहेलियां
paheliyon	पहेलियां		पहेलियों
pide	पीड़े		पाइड
pied	पाइड		पाइड
pythagoras	प्यथागोरास		पाइथागोरस
pythogaras	पिथ्ठागरस		पाइथागोरस
paakhandi	पाखंडी		पाखंडी
pakhandi	पाखंडी		पाखंडी
paathshaalaayein	पाठशालाएं		पाठशालाएं
pathshalayein	पाठशालाएं		पाठशालाएं
pathshalayen	पाठशालाएं		पाठशालाएं
paathyakram	पाठ्यक्रम		पाठ्यक्रम
pathyakram	पाठयक्रम		पाठ्यक्रम
pathykram	पाठ्यक्रम		पाठ्यक्रम
paathyakramon	पाठ्यकर्मों		पाठ्यक्रमों
pathyakramon	पाठ्यकर्मों		पाठ्यक्रमों
pathykramon	पाठ्यक्रमों		पाठ्यक्रमों
population	पोपुलेशन		पापुलेशन
pailot	पेलोट		पायलट
pilot	पिलोटा		पायलट
pailoton	पैलोटों		पायलटों
piloton	पिलोटों		पायलटों
paarampariktaa	पारामपृक्त		पारंपरिकता
paramparikata	पारंपरिकता		पारंपरिकता
paramparikta	पारामपृक्त		पारंपरिकता
parnel	पर्नेल		पार्नेल
parnell	पर्नेल		पार्नेल
parleron	पार्लरों		पार्लरों
parloron	पार्लोरों		पार्लरों
parlouron	पार्लोरों		पार्लरों
paarshad	पार्शद		पार्षद
parshad	पार्षाड़		पार्षद
paarshadon	पार्शड़ों		पार्षदों
parshadon	परशादों		पार्षदों
parshdon	परशदों		पार्षदों
policy	पोलिसी		पालिसी
pinta	पिंट		पिंटा
pintaa	पिंट		पिंटा
piega	पीएग		पिएगा
piyegaa	पिएगा		पिएगा
pic	पीआईसी		पिक
pick	पीके		पिक
pik	पिक		पिक
piki	पिकी		पिकी
piky	पिक्या		पिकी
picture	पिक्चर		पिक्चर
pigmentation	पिजमेंटेशन		पिगमेंटेशन
pigs	पिग्स		पिग्स
pichde	पिछड़े		पिछड़े
pichhade	पिछड़े		पिछड़े
pijja	पिज्ज़ा		पिज्जा
pizza	पिज़्ज़ा		पिज्जा
pitaamaha	पितामह		पितामह
pitamah	पितमाह		पितामह
pipra	पिप्र		पिपरा
pipraa	पिप्र		पिपरा
pipli	पिपली		पिपली
pearson	पैर्सन		पियरसन
pierson	पीयर्सन		पियरसन
peary	पेरी		पियरी
piyari	पीयरी		पियरी
pisaai	पिसाई		पिसाई
pisai	पिसाई		पिसाई
pihaani	पिहानी		पिहानी
pihani	पिहानी		पिहानी
pib	पीबा		पीआईबी
pr	प्रा		पीआर
pml	पीएमएल		पीएमएल
pmo	पो		पीएमओ
pmch	पीचा		पीएमसीएच
psv	पीएसवी		पीएसवी
peaking	पीकिंग		पीकिंग
picking	पिकिंग		पीकिंग
peetne	पीटने		पीटने
pitne	पिटने		पीटने
pedia	पेड़ी		पीडिया
pidiya	पीड़िया		पीडिया
pidiyaa	पीड़िया		पीडिया
peelepan	पीलेपन		पीलेपन
pilepan	पिलेपन		पीलेपन
pv	पीवी		पीवी
pisa	पीआईएस		पीसा
putla	पुतला		पुतला
putlaa	पुतला		पुतला
putaliyaan	पुतालियां		पुतलियां
putliyan	पुटलियां		पुतलियां
putaliyon	पुटालियों		पुतलियों
putliyon	पुटलियों		पुतलियों
putali	पुताली		पुतली
putli	पुतली		पुतली
putale	पुतले		पुतले
putle	पुटले		पुतले
putin	पुटीन		पुतिन
putul	पुतुल		पुतुल
punargathan	पुनर्गठन		पुनर्गठन
puna	पुन		पुना
puraane	पूराने		पुराने
purane	पूराने		पुराने
puru	पुरु		पुरू
purjon	पुर्जों		पुर्जों
purzon	पुर्जों		पुर्जों
pulam	पुलामा		पुलम
pushkin	पुश्किन		पुश्किन
pushkarana	पुष्करण		पुष्करणा
pushkarna	पुष्करण		पुष्करणा
pushkarnaa	पुष्करण		पुष्करणा
pushp	पुश्प		पुष्प
pushpa	पुश्प		पुष्प
pushpa	पुश्प		पुष्पा
pushpaa	पुश्प		पुष्पा
pushpit	पुष्पित		पुष्पित
pushpon	पुश्पों		पुष्पों
poonjikaran	पूंजीकरण		पूंजीकरण
punjikaran	पूंजीकरण		पूंजीकरण
poojaapaath	पूजापाठ		पूजापाठ
poojapath	पूजापठ		पूजापाठ
pujapath	पूजापठ		पूजापाठ
pooranpur	पुरानपुरा		पूरनपुर
puranpur	पुरानपुरा		पूरनपुर
purvaabhaas	पूर्वाभास		पूर्वाभास
purvaabhas	पूर्वाभास		पूर्वाभास
purvabhaas	पूर्वाभास		पूर्वाभास
purvabhas	पूर्वाभास		पूर्वाभास
pendulam	पेंडुलम		पेंडुलम
pendulum	पेंडूल्यूम		पेंडुलम
peg	पेगा		पेग
pages	पैज्स		पेजेज
pajej	पजेज		पेजेज
pace	पेस		पेस
pes	पेसा		पेस
pastry	पास्त्री		पेस्ट्री
pangolin	पंगोलिन		पैंगोलिन
pengolin	पेंगोलिन		पैंगोलिन
packard	पैकार्ड		पैकर्ड
package	पैकेज		पैकेज
packageon	पैकेजन		पैकेजों
packagon	पैकागों		पैकेजों
packajon	पकाजों		पैकेजों
paim	पैमा		पैम
pam	पीएम		पैम
paratrooper	पैराट्रूपर		पैराट्रूपर
peratrupers	पैराट्रूपर्स		पैराट्रूपर
paranormal	परणोरमल		पैरानॉर्मल
peranormal	पैरानोरमल		पैरानॉर्मल
paraffin	पैराफिन		पैराफिन
parafin	पैराफीन		पैराफिन
perafin	पैराफिन		पैराफिन
parabola	पैरबोल		पैराबोला
perabola	पैराबोल		पैराबोला
polimer	पॉलिमर		पॉलिमर
polymer	पॉलिमर		पॉलिमर
polishing	पॉलिशिंग		पॉलिशिंग
pokar	पोकर		पोकर
poker	पोकर		पोकर
polish	पालिश		पोलिश
poshit	पोषित		पोषित
posta	पोस्त		पोस्ता
pau	पाऊं		पौ
pyade	प्यादे		प्यादे
prakriya	प्रक्रिय		प्रक्रिया
prakshepak	प्रक्षेपक		प्रक्षेपक
pratigya	प्रतिज्ञ		प्रतिज्ञा
prtigyaa	प्रतिज्ञ		प्रतिज्ञा
pratibhutiyan	प्रतिभूतियां		प्रतिभूतियां
pratiyon	प्रतियों		प्रतियों
prativaad	प्रतिवाद		प्रतिवाद
prativad	प्रतिवाद		प्रतिवाद
prativadi	प्रतिवादी		प्रतिवादी
pratishat	प्रतिष्ट		प्रतिशत
praneet	प्रानीत		प्रनीत
pranit	प्राणीत		प्रनीत
prapaat	प्रपात		प्रपात
prapat	प्रपात		प्रपात
prapaaton	प्रपातों		प्रपातों
prapaton	प्रपातों		प्रपातों
prabodhini	प्रबोधिनी		प्रबोधिनी
prayaasrat	प्रयास्रत		प्रयासरत
prayasarat	प्रयसर्त		प्रयासरत
pradarshan	प्रदर्शन		प्रर्दशन
prardashan	प्रार्दशन		प्रर्दशन
pravati	प्रवति		प्रवत्ति
pravatti	प्रवत्ति		प्रवत्ति
prashaasanik	प्रशासनिक		प्रशासनिक
prashasanik	प्रशासनिक		प्रशासनिक
prashasnik	प्रशासनिक		प्रशासनिक
prashaasanon	प्रशासनों		प्रशासनों
prashansanon	प्रशंसनों		प्रशासनों
prashasanon	प्रशासनों		प्रशासनों
prashikshu	प्रशिक्षु		प्रशिक्षु
prastaavon	प्रस्तावों		प्रस्तावों
prastavon	प्रस्तावों		प्रस्तावों
prahlaad	प्रहलाद		प्रहलाद
prahlad	प्रहलाद		प्रहलाद
prahasan	प्रह्रण		प्रहसन
prahsan	प्रशन		प्रहसन
prahaarak	प्रहारक		प्रहारक
praharak	प्रहारक		प्रहारक
prahad	प्रहाद		प्रह्लाद
prahlad	प्रहलाद		प्रह्लाद
privacy	प्रिवेसी		प्राइवेसी
praakkathan	प्राक्षाथन		प्राक्कथन
prakkathan	प्रक्काथन		प्राक्कथन
praan	प्राण		प्राण
pran	प्राण		प्राण
pranon	प्रणों		प्राणों
prathamik	प्राथमिक		प्राथमिक
prathmik	प्राथमिक		प्राथमिक
praathmikata	प्राथ्मीकता		प्राथमिकता
prathmikta	प्राथमिकता		प्राथमिकता
prathmiki	प्राथमिकी		प्राथमिकी
pradhyapakon	प्रध्यापकों		प्राध्यापकों
prapt	प्राप्त		प्राप्त
prapta	प्राप्त		प्राप्त
prapti	प्राप्ति		प्राप्ती
praroop	प्ररूप		प्रारूप
prarup	प्ररूप		प्रारूप
priyamani	प्रियमानी		प्रियामणि
proof	प्रूफ		प्रूफ
pruf	प्रूफ		प्रूफ
prekshakon	प्रेक्षकों		प्रेक्षकों
prem	प्रेम		प्रेम
premlata	प्रेमलता		प्रेमलता
prema	प्रेम		प्रेमा
premi	प्रेमी		प्रेमी
profit	प्रोफित		प्रॉफिट
processing	प्रोसेसिंग		प्रॉसेसिंग
programers	प्रोग्रामर्स		प्रोग्रामर्स
programmers	प्रोग्रामर्स		प्रोग्रामर्स
programs	प्रोग्रांस्स		प्रोग्रामर्स
proto	प्रोतो		प्रोटो
propellant	प्रोपलैंट		प्रोपेलेंट
propellent	प्रोपलेंट		प्रोपेलेंट
praudh	प्रौढ़		प्रौढ
proud	प्रूड		प्रौढ
plan	प्लैन		प्लेन
plane	प्लैने		प्लेन
fund	फुंडा		फंड
funda	फुंडा		फंडा
funding	फंडिंग		फंडिंग
fandon	फांडों		फंदों
fagua	फागू		फगुआ
fatane	फाटने		फटने
phatane	फटने		फटने
phatne	फटने		फटने
fadfadata	फद्फडता		फड़फड़ाता
phadphadata	फड़फड़ता		फड़फड़ाता
fatehgadh	फतेहगढ़		फतेहगढ़
fatehgarh	फतेहगढ़		फतेहगढ़
fabti	फबती		फब्ती
phabti	फबटी		फब्ती
farse	फर्स		फरसे
pharase	फरसे		फरसे
pharse	फर्से		फरसे
farheen	फरहीन		फरहीन
farhin	फरहीं		फरहीन
farth	फर्थ		फर्थ
ferth	फर्थ		फर्थ
pharth	फर्थ		फर्थ
farmion	फर्मियों		फर्मिऑन
fermion	फर्मियन		फर्मिऑन
firmian	फर्मियां		फर्मिऑन
farookhabad	फरुखाबड़		फर्रुखाबाद
farrukhabad	फर्रुखाबाद		फर्रुखाबाद
farukhabad	फरुखाबाद		फर्रुखाबाद
farookhnagar	फरुखनगर		फर्रूखनगर
farrukhnagar	फररूखनागार		फर्रूखनगर
farukhnagar	फरुखनगर		फर्रूखनगर
falata	फलत		फलता
falta	फलता		फलता
phalata	फलत		फलता
falne	फलने		फलने
phalne	फलने		फलने
falitarth	फलितार्थ		फलितार्थ
phalitartha	फलितार्थ		फलितार्थ
falibhoot	फलीभूत		फलीभूत
falibhut	फलीभूत		फलीभूत
phalibhoot	फलीभूत		फलीभूत
favvara	फववर		फव्वारा
fawaara	फवार		फव्वारा
favvare	फववेरे		फव्वारे
fawaare	फवारे		फव्वारे
favvaron	फववरों		फव्वारों
fawaaron	फवारों		फव्वारों
faisala	फैसल		फ़ैसला
faisla	फैसला		फ़ैसला
follow	फोलो		फ़ॉलो
faansi	फांसी		फांसी
fansi	फैंसी		फांसी
fatama	फटम		फातमा
fatma	फटमा		फातमा
faaf	फाफ		फाफ
phaaph	फाफा		फाफ
farsi	फर्सी		फारसी
forcee	फोर्सी		फारसी
farm	फर्मों		फार्म
form	फ़ॉर्म		फार्म
farmic	फर्मिका		फार्मिक
formic	फोर्मिक		फार्मिक
formulae	फोरमुलाई		फार्मूले
formule	फार्मूल		फार्मूले
formuley	फार्मूलिया		फार्मूले
pharmacy	फरमासी		फार्मेसी
pharma	फरम		फार्मों
pharmon	फर्मों		फार्मों
farms	फर्म्स		फार्म्स
finger	फिंगर		फिंगर
fikra	फिक्र		फिक्र
physician	फिजिशियन		फिजिशियन
firti	फीरती		फिरती
fisla	फीसला		फिसला
fislaa	फीसला		फिसला
feeder	फीडर		फीडर
fulaaye	फुलाए		फुलाए
fulae	फुलाई		फुलाए
fulay	फुलाया		फुलाए
furti	फुर्ती		फूर्ति
phurti	फूरती		फूर्ति
fus	फूस		फूस
phoos	फूस		फूस
phus	फूस		फूस
feka	फेक		फेका
fefada	फेफड़		फेफड़ा
fefda	फेफड़ा		फेफड़ा
facial	फेसल		फेशियल
fact	फैक्ट		फैक्ट
federal	फेडरल		फैडरल
failkar	फैलकर		फैलकर
failaaiye	फैलाइये		फैलाइए
failaea	फैलाए		फैलाइए
failaiya	फैलाइया		फैलाइए
failaiye	फैलाइय		फैलाइए
failegi	फैलेगी		फैलेगी
font	फ़ॉन्ट		फॉन्ट
fogat	फोगता		फोगाट
phogat	फोगट		फोगाट
fod	फोडा		फोड़
phod	फोडा		फोड़
foda	फोडा		फोड़ा
fodaa	फोडा		फोड़ा
phoda	फोडा		फोड़ा
fode	फोड		फोड़े
phode	फोड़		फोड़े
fodo	फोडो		फोड़ों
fodon	फोड़ों		फोड़ों
phodo	फोडो		फोड़ों
fortis	फोर्टिस		फोर्टिस
fusion	फुस्योन		फ्यूजन
fuji	फूजी		फ्यूजी
fyuji	फ़यूजी		फ्यूजी
francisca	फ्रैंसिस्क		फ्रांसिस्का
franciska	फ्रैंसिस्क		फ्रांसिस्का
fransiska	फ्रैंसिस्क		फ्रांसिस्का
francisco	फ्रैंसिस्को		फ्रांसिस्को
francisko	फ्रैंसिस्कों		फ्रांसिस्को
fransisko	फ्रैंसिस्को		फ्रांसिस्को
fringe	फ्रिंग		फ्रिंज
friendship	फ्रेंडशिप		फ्रेंडशिप
frost	फ्रोस्ट		फ्रॉस्ट
flin	फ्लिन		फ्लिन
flynn	फ्लाइन		फ्लिन
flesh	फ्लैश		फ्लेश
bang	बैंग		बंग
bung	बुंग		बंग
bangbandhu	बंगबंदु		बंगबंधु
bangbhang	बैंगभंग		बंगभंग
bangash	बांगशा		बंगश
bangsh	बांगशा		बंगश
bantane	बांटने		बंटने
bantne	बांटने		बंटने
bandhati	बंधती		बंधती
bandhti	बंधती		बंधती
bandhan	बंधन		बंधान
bandhuon	बंधुओं		बंधुओं
bamba	बम		बंबा
mumba	मुंबा		बंबा
bakaayon	बकायों		बकायों
bakayon	बकायों		बकायों
bakaul	बकौल		बकौल
bakoul	बकूल		बकौल
baksa	बक्स		बक्सा
baksi	बकसी		बक्सी
bakse	बक्से		बक्से
bakhshane	बख़्शने		बख्शने
bakhshne	बख़्नहे		बख्शने
bagad	बागद		बगड़
bagd	बागड़		बगड़
bageechi	बगीची		बगीची
bagichi	बगीची		बगीची
bachat	बचाता		बचत
bachati	बचाती		बचती
bachti	बचती		बचती
bajana	बजन		बजना
bajrangi	बजरंगी		बजरंगी
bajaj	बजाज		बजाज
batalvi	बतलवी		बटालवी
badhachadhakar	बधाचाधकर		बढ़ाचढ़ाकर
badata	बादता		बढ़ाता
badhaataa	बढ़ाता		बढ़ाता
badhata	बढ़ता		बढ़ाता
badhaati	बढ़ाती		बढ़ाती
badhati	बढ़ती		बढ़ाती
badhayi	बढ़ाई		बढ़ायी
badhav	बढ़ावा		बढ़ाव
badhotari	बढ़ोतरी		बढ़ोतरी
badhotri	बाधोत्री		बढ़ोतरी
batlaae	बतलाई		बतलाए
batlaaye	बतलाए		बतलाए
batlae	बतलाई		बतलाए
batlaye	बतलाए		बतलाए
batlaakar	बतलाकर		बतलाकर
batlakar	बातलकर		बतलाकर
badlapur	बदलापुर		बदलापुर
badali	बदली		बदली
badli	बदली		बदली
badam	बादाम		बदाम
banva	बनवा		बनवा
banvaa	बनवा		बनवा
banaam	बनाम		बनाम
banam	बनाम		बनाम
bnaam	बनाम		बनाम
baniya	बनिया		बनिया
banu	बांगू		बनू
barpaayaa	बरपाया		बरपाया
barpaya	बरपिया		बरपाया
barsa	बरस		बरसा
barsaata	बरसात		बरसाता
barsaataa	बरसात		बरसाता
barsata	बरसात		बरसाता
barhad	बारहद		बरहद
baraat	बारात		बरात
barat	बारात		बरात
braat	ब्रात		बरात
baraamad	बरामदा		बरामद
baramad	बारामद		बरामद
bramad	ब्रमाढ़		बरामद
baramade	बरामदे		बरामदे
baramde	बरामडे		बरामदे
bare	बाड़े		बरे
birth	बर्थ		बर्थ
baljeet	बल्जीत		बलजीत
baljit	बलजीत		बलजीत
ballabh	बल्लभ		बल्लभ
balla	बॉल		बल्ला
balli	बलिया		बल्ली
basava	बसव		बसावा
bastiyon	बस्तियों		बस्तियों
bahroopiya	बाहरूपीय		बहरूपिया
bahrupiya	बहरूपीय		बहरूपिया
bahamaas	बहमास		बहामास
bahamas	बहमास		बहामास
bahaav	बहाव		बहाव
bahav	बहवा		बहाव
bhav	भाव		बहाव
bahavalpur	बहवलपुर		बहावलपुर
bahawalpur	बहवलपुर		बहावलपुर
bahuchara	बहुचार		बहुचरा
banthia	बंथी		बांठिया
banthiya	बंथिया		बांठिया
bandhate	बंधाते		बांधते
bandhte	बंधते		बांधते
banbi	बांबी		बांबी
bombi	बोमबी		बांबी
bounceron	बाउंसरों		बाउंसरों
bowling	बोलिंग		बाउलिंग
baku	बकुआ		बाकू
bakuu	बकुआ		बाकू
baag	बाग		बाग
bag	बैग		बाग
bagh	बाघा		बाग
bagabani	बागबानी		बागबानी
bagbani	बग्बानी		बागबानी
bagali	बगली		बागली
bagli	बगली		बागली
baagiyon	बागियों		बागियों
bagiyon	बागियों		बागियों
baago	बागो		बागो
bago	बागो		बागो
baji	बाजी		बाज़ी
bazi	बाजी		बाज़ी
bajaru	बजारू		बाजारू
bazaru	बजारू		बाजारू
bajuon	बाजूओं		बाजुओं
badh	बढ़		बाध
badha	बढ़		बाधा
baadhaaon	बाधाओं		बाधाओं
baadhaon	बाधाओं		बाधाओं
badhaaon	बाधाओं		बाधाओं
badhaon	बाधाओं		बाधाओं
baadhit	बाधित		बाधित
badhit	बढ़िता		बाधित
baani	बानी		बानी
bani	बानी		बानी
baapa	बाप		बापा
baapaa	बाप		बापा
bapa	बाप		बापा
bapaa	बाप		बापा
baabat	बाबत		बाबत
babat	बाबता		बाबत
babt	बाबता		बाबत
bayern	बायरना		बायर्न
byrun	ब्यरून		बायर्न
barah	बारह		बारह
baarahamaasee	बारहमासी		बारहमासी
barahamasi	बारहमसी		बारहमासी
barahmasi	बारहमासी		बारहमासी
barahsinga	बारहसिंग		बारहसिंगा
barasingha	बारसिंह		बारहसिंगा
bala	बल		बाला
baalti	बालती		बाल्टी
balti	बलती		बाल्टी
balty	बाल्टी		बाल्टी
baldvin	बाल्डविन		बाल्डविन
baldwin	बैल्डविन		बाल्डविन
bavaji	बावजी		बावजी
bavji	बावजी		बावजी
baawaraa	बावार		बावरा
bavra	बावरा		बावरा
bawara	बवार		बावरा
baahulya	बाहुल्य		बाहुल्य
bahuly	बहुल्य		बाहुल्य
bahulya	बहुल्य		बाहुल्य
box	बॉक्स		बाॅक्स
bikherati	बिखेडती		बिखेरती
bikherti	बिखेरती		बिखेरती
biggest	बिगेस्ट		बिगेस्ट
bichhua	बिच्छू		बिछुआ
bichhuaa	बिच्छू		बिछुआ
biji	बीजी		बिजी
busy	बुसी		बिजी
buzy	बज्य		बिजी
bipin	बीपिन		बिपिन
bilae	बिलाए		बिलाई
bilai	बिलाई		बिलाई
billa	बिल		बिल्ला
billaa	बिल		बिल्ला
bilhaur	बिलहर		बिल्हौर
bisva	बिस्व		बिस्वा
biswa	बिस्व		बिस्वा
bag	बैग		बीएजी
bikaner	बिकनेर		बीकानेर
bikaneri	बिकनेरी		बीकानेरी
bk	बीके		बीके
beejak	बीजक		बीजक
bijak	बिजक		बीजक
beef	बीफा		बीफ
beem	बीमा		बीम
bim	बीमा		बीम
beemon	बीमों		बीमों
bimon	बीमों		बीमों
beerganj	बीरगंज		बीरगंज
birganj	बिरगंज		बीरगंज
beesavaan	बीसवान		बीसवां
bisavan	बीसवान		बीसवां
bisawan	बिसवन		बीसवां
beast	बेस्ट		बीस्ट
budvig	बुडविग		बुडविग
budwig	बुडविग		बुडविग
bull	बुल्ला		बुल
bulaao	बुलाओ		बुलाओ
bulao	बुलाओ		बुलाओ
bule	बुले		बुले
bulletin	बुलेटिना		बुलेटिन
brijesh	बृजेश		बृजेश
benvar	बेनवार		बेंवर
benwar	बेनवार		बेंवर
beaulad	बालद		बेऔलाद
bekaaboo	बेकाबू		बेकाबू
bekabu	बेकबू		बेकाबू
bechakar	बेचकर		बेचकर
bechkar	बेचकर		बेचकर
bechate	बेचते		बेचते
bechte	बेचते		बेचते
bediyan	बेडियां		बेड़ियां
bethanal	बेथानाल		बेथनल
bethnal	बेथनाल		बेथनल
benis	बेनिस		बेनिस
belacha	बेलच		बेलचा
belcha	बेलचा		बेलचा
belinda	बेलिंद		बेलिंडा
bevkufana	बेवकूफन		बेवकूफाना
bewakoofaanaa	बेवकूफन		बेवकूफाना
bewkufana	बेयकुफन		बेवकूफाना
besahaaraa	बेसहार		बेसहारा
besahara	बेसहर		बेसहारा
basin	बसीना		बेसिन
besin	बेसिन		बेसिन
basil	बसीला		बेसिल
besil	बेसिल		बेसिल
bandage	बैंडेज		बैंडेज
bandej	बंदेज		बैंडेज
baithantey	बैठांटे		बैठते
baithate	बैठाते		बैठते
baitool	बैटूल		बैतूल
baitul	बैटुल		बैतूल
betul	बेतुल		बैतूल
baini	बैनी		बैनी
beni	बेनी		बैनी
bairakpur	बैराकपुर		बैरकपुर
barrackpore	बैराकप्पर		बैरकपुर
baila	बेल		बैला
bella	बेल		बैला
ballistic	बालिस्टिक्स		बैलिस्टिक
bells	बेल्स		बैल्स
bostan	बोस्न		बॉस्टन
bosten	बोस्वें		बॉस्टन
boston	बोस्टों		बॉस्टन
bokaro	बोकरों		बोकारो
bodara	बोदर		बोदरा
bodra	बोद्र		बोदरा
bodraa	बोद्र		बोदरा
bona	बोना		बोना
borkar	बोरकर		बोरकर
borivali	बोरीवाली		बोरीवली
boriwali	बोरीवाली		बोरीवली
born	बॉर्नन		बोर्न
bolane	बोलने		बोलने
boliae	बोली		बोलिए
boliy	बोलिया		बोलिए
boliye	बोलिया		बोलिए
bosaan	बोसान		बोसान
bosan	बोस्न		बोसान
bauni	बौनी		बौनी
bouni	बौनी		बौनी
byaawa	ब्याव		ब्यावर
byavar	ब्यावर		ब्यावर
brajesh	बृजेश		ब्रजेश
brijesh	बृजेश		ब्रजेश
brahmalin	ब्रह्मलीन		ब्रह्मलीन
brahmleen	ब्रह्मलीन		ब्रह्मलीन
brahmlin	ब्रह्मलिन		ब्रह्मलीन
bravo	ब्रेवो		ब्रावो
brigatn	ब्रिगेटन		ब्रिगटन
brighton	ब्राइटन		ब्रिगटन
brigton	ब्रिग्टन		ब्रिगटन
brigadier	ब्रिगाड़ीर		ब्रिगेडियर
britain	ब्रिटेन		ब्रिटेन
breed	ब्रीड		ब्रीद
brock	ब्रॉक		ब्रोक
brok	ब्रॉक		ब्रोक
broke	ब्रॉक		ब्रोक
brocken	ब्रॉकेन		ब्रोकन
broken	ब्रोकेन		ब्रोकन
blosam	ब्लोसम		ब्लॉसम
blossom	ब्लोसम		ब्लॉसम
bhagaane	भगाने		भगाने
bhagane	भागने		भगाने
bhadakaaya	भड़काय		भड़काया
bhadakaya	भदकय		भड़काया
bhadkaayaa	भदकाया		भड़काया
bhadkaya	भड़काय		भड़काया
bharakaaya	भड़काय		भड़काया
bharakaya	भड़कया		भड़काया
bhabhoot	भभूत		भभूत
bhabhut	भभूत		भभूत
bhay	भय		भय
bhaya	भय		भय
bhayo	भायो		भयो
bharatanatyam	भारतनाट्यम		भरतनाट्यम्
bharatnatyam	भारतनाट्यम		भरतनाट्यम्
bhartnatyam	भारतनाट्यम		भरतनाट्यम्
bharate	भारते		भरते
bharte	भर्ते		भरते
bharani	भरणी		भरनी
bharni	भरणी		भरनी
bharane	भरने		भरने
bharne	भरने		भरने
bhara	भर		भरा
bhavishya	भाविष्य		भविष्य
bhaate	भाते		भाते
bhate	भाटे		भाते
bhanu	भानु		भानू
bhabar	भाबरा		भाबर
bhareeye	भरीय		भारीय
bhariy	भारिया		भारीय
bhavanaon	भवनाओं		भावनाओं
bhavnaon	भावनाओं		भावनाओं
bhaskar	भास्कर		भास्कर
bheed	भीड		भीड़
bheera	भीर		भीरा
bhira	भीरा		भीरा
bheesham	भीशम		भीष्म
bhisham	भिक्षम		भीष्म
bhishm	भिक्षा		भीष्म
bhugat	भुगता		भुगत
bhugata	भुगता		भुगता
bhugta	भुगता		भुगता
bhutto	भूट्टू		भुट्टो
bhumi	भूमि		भुमि
bhurbhura	भुरभुर		भुरभुरा
bhookh	भूख		भूख
bhukh	भूख		भूख
bhookhi	भूखी		भूखी
bhukhi	भुखी		भूखी
bhoogol	भूगोल		भूगोल
bhugol	भुगोला		भूगोल
bhootal	भूतल		भूतल
bhutal	भूतल		भूतल
bhoopsingh	भूपसिंह		भूपसिंह
bhupsingh	भूपसिंह		भूपसिंह
bhumi	भूमि		भूमी
bhumika	भूमिका		भूमी
bhulata	भुलता		भूलता
bhulataa	भुलता		भूलता
bhulta	भुल्त		भूलता
bhula	भुला		भूला
bhulaa	भुला		भूला
bhooli	भूली		भूली
bhuli	भुली		भूली
bhulo	भूलो		भूलो
bhulon	भूलों		भूलों
bhusi	भूसी		भूसी
bhooswaami	भूस्वामी		भूस्वामी
bhusvami	भूस्वामी		भूस्वामी
bhuswami	भूस्वामी		भूस्वामी
bhengapan	भेंगपन		भेंगापन
bhairavnath	भैरावनाथ		भैरवनाथ
bhairo	भैरो		भैरो
bhogatey	भोगते		भोगते
bhogte	भोगते		भोगते
bhola	भोला		भोला
bholi	भोली		भोली
bholu	भोलु		भोलू
bhaunho	भौनहो		भौंहों
bhaunhon	भौनहों		भौंहों
bhoonhon	भूनुहों		भौंहों
bhraant	भरांत		भ्रांत
bhrant	भ्रांत		भ्रांत
brant	ब्रंट		भ्रांत
bhraanti	भरांती		भ्रांति
bhranti	भ्रांती		भ्रांति
branti	ब्रंति		भ्रांति
bhraantiyan	भ्रांतियां		भ्रांतियां
bhrantiyan	भ्रांतियां		भ्रांतियां
bhraantiyon	भ्रांतियों		भ्रांतियों
bhrantiyon	भ्रंतियों		भ्रांतियों
mangesh	मांगेश		मंगेश
manch	मांच		मंच
manchit	मानचित		मंचित
mancheeye	मांचिये		मंचीय
manchiy	मांचिया		मंचीय
manchiya	मांचिया		मंचीय
manchon	मानचों		मंचों
manjil	मंजीला		मंजिल
manzil	मंजीला		मंजिल
manjila	मंजीला		मंजिला
manzila	मंजीला		मंजिला
manjilein	मंजीलें		मंजिलें
manjilen	मंजीलें		मंजिलें
manzilein	मंजीलें		मंजिलें
manto	मांटो		मंटो
mantriyon	मंत्रियों		मंत्रियों
makrani	मकरानी		मकरानी
maksad	मकसद		मक्सद
makhdumpur	माखजुंपुर		मखदुमपुर
machaaye	मचाए		मचाए
machae	मचाए		मचाए
machaye	मचाए		मचाए
machaanon	मचानों		मचानों
machanno	मिचन्नो		मचानों
machano	मचनों		मचानों
machanon	मचानों		मचानों
madaura	मदौर		मढ़ौरा
madhuara	मधुर		मढ़ौरा
madhura	मधुर		मढ़ौरा
manipal	मनिपाल		मणिपाल
matpatron	मातपत्रों		मतपत्रों
matthe	मत्थे		मत्थे
matsyavatar	मत्सशावतार		मत्स्यावतार
matsyavtar	मत्स्यवत्र		मत्स्यावतार
masyendranath	मस्येंद्रनाथ		मत्स्येंद्रनाथ
matsyendranath	मत्स्येद्रानाथ		मत्स्येंद्रनाथ
madhupur	मधुपुर		मधुपुर
manmarji	मानमर्जी		मनमर्जी
manae	मनाई		मनाए
manaye	मनाय		मनाए
mnaey	मन्ने		मनाए
mam	मामा		मम
mum	मुम		मम
maryokar	मरीकर		मयोर्का
mayorka	मेयर्क		मयोर्का
mayorkaa	मेयर्क		मयोर्का
mardaani	मर्दानी		मरदानी
mardani	मर्दानी		मरदानी
marmar	मर्मर		मरमर
murmur	मूरमूर		मरमर
maratha	मराठा		मराठा
marathi	मराठी		मराठी
marji	मर्जी		मर्जी
mardanagi	मर्दानागी		मर्दानगी
mardangi	मर्दंगी		मर्दानगी
mardo	मार्डो		मर्दों
mardon	मर्दों		मर्दों
maryaadaa	मार्याद		मर्यादा
maryada	मार्यड		मर्यादा
maryaadaaon	मर्यादाओं		मर्यादाओं
maryadaon	मार्यादाओं		मर्यादाओं
malaga	मलाग		मलागा
malaar	मालार		मलार
malar	मालार		मलार
mashrak	मश्रक		मशरक
masaaledaar	मसलेदार		मसालेदार
masaledaar	मसलेदार		मसालेदार
masaledar	मसलेदार		मसालेदार
masoor	मसूर		मसूर
masur	मसूर		मसूर
masse	मसे		मस्से
mahakane	महकाने		महकने
mahakne	महकने		महकने
mahkane	महकने		महकने
mehkane	महकने		महकने
mahalon	महालों		महलों
mahlon	महलों		महलों
mahagranth	महाग्रेंथ		महाग्रंथ
mhagranth	महाग्रंथ		महाग्रंथ
mahajan	महजन		महाजन
mhajan	महाजन		महाजन
mahathir	महातिर		महाथिर
mhathir	महातिर		महाथिर
mahanatam	महानतम		महानतम
mahantam	महांतम		महानतम
mhantam	महांतम		महानतम
mahanideshak	महानिदेशक		महानिदेशक
mahanirdeshak	महानिर्देशक		महानिदेशक
mhanideshak	महानिदेशक		महानिदेशक
mahapauron	महापुरों		महापौरों
mhapauron	महापुरों		महापौरों
mahapran	महाप्रण		महाप्राण
mhapran	महाप्रण		महाप्राण
mahamantr	महामंत्र		महामंत्र
mahamantra	महामंत्र		महामंत्र
mhamantra	महामंत्र		महामंत्र
maharaja	महाराज		महाराजा
mahavigyan	महाविज्ञान		महाविज्ञान
mhavidyan	महाविद्यान		महाविज्ञान
mahavidya	महाविद्य		महाविद्या
mhavidya	महाविद्य		महाविद्या
mahavishnu	महाविषण		महाविष्णु
mahasingh	महासिंह		महासिंह
mahasinh	महासिंह		महासिंह
mahipal	महिपाल		महिपाल
mahin	महिना		महीन
mahinon	महिनों		महीनों
maang	मांग		मांग
mang	मंगा		मांग
mangani	मंगानी		मांगनी
mangni	मांगनी		मांगनी
maanga	मांग		मांगा
manga	मंगा		मांगा
maangi	मांगी		मांगी
mangi	मांगी		मांगी
maange	मागे		मांगे
mange	मागें		मांगे
mango	मांगों		मांगो
maori	मारी		माओरी
maajin	माजिन		माजिन
majin	मजीन		माजिन
mathe	माठे		माथे
mathey	माथेय		माथे
maap	माप		माप
map	मैप		माप
mop	मोपा		माप
mamooli	ममूली		मामूली
mamuli	मामूली		मामूली
mame	मैम		मामे
maarvaad	मारवाड़ा		मारवाड़
marvad	मारवाड़ा		मारवाड़
marwar	मरवार		मारवाड़
maariya	मारिया		मारिया
mariya	मरिया		मारिया
maariyo	मारियो		मारियो
mario	मैरियो		मारियो
mariyo	मैरियो		मारियो
martha	मार्थ		मार्था
maalish	मालीश		मालिश
malish	मालिश		मालिश
mave	मावे		मावे
mavey	मवे		मावे
maas	मांस		मास
mas	मसा		मास
mass	मैस		मास
maason	मासों		मासों
mason	मसों		मासों
mitaao	मिटाओ		मिटाओ
mitao	मिटाओं		मिटाओ
mithaai	मिथाई		मिठाई
mithai	मिथाई		मिठाई
media	मेडी		मिडिया
mithila	मिथल		मिथिला
mithilanchal	मिथिलंचल		मिथिलांचल
mithya	मिथी		मिथ्या
mimicry	मिमिक्री		मिमिक्री
milkiyat	मिलकियत		मिल्कियत
misha	मिश		मिशा
mungeri	मंगरी		मुंगेरी
mundva	मुंडवा		मुंडवा
mundwa	मुंडा		मुंडवा
munshiganj	मुंशिगंज		मुंशीगंज
mukarte	मुकरते		मुकरते
mukartey	मुकरते		मुकरते
mukhopadhyaya	मुखोपाध्याय		मुखोपाध्याय
mukhyopadhyaay	मुख्योपाध्याय		मुखोपाध्याय
mukhyamantri	मुख्यमंत्री		मुख्यमंत्री
munaf	मुनफा		मुनाफ
munafa	मुनफा		मुनाफा
munnu	मुन्नू		मुन्नू
mufalisi	मुफलिसी		मुफलिसी
muflisi	मफलिसी		मुफलिसी
mubarakpur	मुबरकपुर		मुबारकपुर
mubarkpur	मुबरकपुर		मुबारकपुर
murjha	मुरझा		मुर्झा
multae	मल्टाए		मुल्ताई
multai	मलते		मुल्ताई
mushahid	मुशहिद		मुशाहिद
muhavare	मुहावरे		मुहावरे
muhavre	मुहावरे		मुहावरे
mooth	मूठा		मूठ
muth	मूठ		मूठ
mood	मूद		मूड
mud	मुड़		मूड
moodi	मूदी		मूडी
moody	मूद्य		मूडी
mool	मूला		मूल
mul	मूला		मूल
moolchand	मूलचंद		मूलचंद
mulchand	मुलचंड		मूलचंद
moolar	मूलर		मूलर
mular	मूलर		मूलर
muller	म्यूलर		मूलर
moolon	मूलों		मूलों
mulon	मूलों		मूलों
maxico	मैक्सिको		मेक्सिको
mexico	मैक्सिको		मेक्सिको
mega	मेग		मेगा
megapixal	मैगापिकल		मेगापिक्सल
megapixel	मैगाप्कल		मेगापिक्सल
mejbaan	मेजबान		मेजबान
mejban	मेजबान		मेजबान
mezbaan	मेजबान		मेजबान
mejabani	मेजबानी		मेजबानी
mejbaani	मेजबानी		मेजबानी
mejbani	मेजबेनिया		मेजबानी
mezabani	मेजबानी		मेजबानी
mejbaan	मेजबान		मेज़बान
mejban	मेजबान		मेज़बान
mezbaan	मेजबान		मेज़बान
mejbaani	मेजबानी		मेज़बानी
mejbani	मेजबेनिया		मेज़बानी
mezbaani	मेजबानी		मेज़बानी
mate	मैट		मेट
met	मेटा		मेट
mates	मैट्स		मेट्स
medical	मैडिकल		मेडीकल
methanol	मेथनॉल		मेथेनॉल
menu	मेन्य		मेनू
mem	मेमा		मेम
melaghaat	मेलघाट		मेलघाट
melghat	मेलघाटा		मेलघाट
melaanin	मेलानिन		मेलानिन
melanin	मेलेनिना		मेलानिन
melaani	मेलानी		मेलानी
melani	मेलनी		मेलानी
maheman	महमान		मेहमान
mehamaan	मेहमान		मेहमान
mehaman	मेहमैन		मेहमान
mehmaan	मेहमान		मेहमान
mehman	मेहमन		मेहमान
meharaam	मेहरम		मेहराम
mehram	मेहरमा		मेहराम
macbook	मैकबुक		मैकबुक
matix	मैटिक्स		मैट्रिक्स
matrix	मैट्रिक्स		मैट्रिक्स
mad	मढ़ा		मैड
made	मैड		मैड
maid	मैदा		मैड
maddy	मद्ध		मैडी
maidi	मैदी		मैडी
main	मैं		मैन
man	माना		मैन
men	मेन		मैन
mainan	मैंनन		मैनन
menon	मेनों		मैनन
manner	मन्नेर		मैनर
maina	मैं		मैना
maine	मैंटे		मैने
marrej	मरेज़		मैरेज
marriage	मैरिज		मैरेज
merraige	मैरेज		मैरेज
maisachusets	मैसेच्यूश्स		मैसाचुसेट्स
massachusetts	मेसाचुसेट्स		मैसाचुसेट्स
maisor	मैसूर		मैसोर
maisore	मैसोर		मैसोर
mysore	मैसूर		मैसोर
mod	मोड़		मॉड
mode	मोड़		मॉड
modern	मोडर्ना		मॉडर्न
module	मोड़ुले		मॉड्यूल
modules	मोडुल्स		मॉड्यूल्स
modyuls	मोड्यूल्स		मॉड्यूल्स
mauritious	मरीशस		मॉरिशस
mauritius	मॉरीशस		मॉरिशस
mogali	मोगली		मोगली
mowgli	मूगलिया		मोगली
motive	मोटिव		मोटिव
mol	मोला		मोल
mold	मॉल्ड		मोल्ड
moshe	मोशे		मोशे
mosad	मोसद		मोसाद
mohana	मोहन		मोहाना
mohani	मोहनी		मोहानी
mohini	मोहिनी		मोहिनी
mohim	मोहिम		मोहिम
maukon	मौकों		मौकों
mauma	मौमा		मौमा
maurya	मौरी		मौर्या
morya	मोरय		मौर्या
maurya	मौरी		मौर्यों
mauryon	मौर्यों		मौर्यों
moryon	मोरियोन		मौर्यों
maulaviyon	मौलवियों		मौलवियों
maulvidon	मौलविडों		मौलवियों
maulviyon	मौलवियों		मौलवियों
maule	मौले		मौले
mauley	मौले		मौले
mausa	मौसा		मौसा
yatn	यतना		यत्न
yatna	यतना		यत्न
yada	याद		यदा
yda	ईएजए		यदा
yaduvansh	यादुवंश		यदुवंश
yaduwansh	यादुवंश		यदुवंश
jerusalem	जेरूसलम		यरूशलेम
yarooshaleim	यारूशोल		यरूशलेम
yarushalem	यारुशलेम		यरूशलेम
yashpaal	याषपाल		यशपाल
yashpal	यशपाल		यशपाल
yaatna	यातना		यातना
yatna	यतना		यातना
yaatanaon	यातनाओं		यातनाओं
yatnaon	यतनाओं		यातनाओं
yarayan	यारयन		यात्राएं
yatraein	यात्राएं		यात्राएं
yatraen	यात्राएं		यात्राएं
yaariyan	यारियां		यारियां
yariyan	यारियां		यारियां
yaari	यारी		यारी
yari	यारी		यारी
yugam	युगम		युग्म
yugm	युगमा		युग्म
yuddhrat	युद्धृत		युद्धरत
yudhrat	युद्धरता		युद्धरत
ukrainian	उक्रेनियन		यूक्रेनियन
ukranian	उक्रानियन		यूक्रेनियन
jerusalem	जेरूसलम		येरुशलम
yorker	योर्कर		यॉर्कर
yojanaein	योजनाएं		योजनाएं
yojanaen	योजनाएं		योजनाएं
yojanaye	योजनाए		योजनाएं
rangate	रंगते		रंगते
rangte	रंगते		रंगते
rangkata	रंगकता		रंजकता
ranjkatha	रंजकथ		रंजकता
ranjkta	रणामकता		रंजकता
raees	रीसा		रईस
rais	रैसा		रईस
raktaabh	रक्ताभ		रक्ताभ
raktabh	रक्तभा		रक्ताभ
rakhna	रखना		रखना
raghupati	रघुपति		रघुपति
raghuram	रघुराम		रघुराम
registerd	रेजिस्टर्ड		रजिस्टर्ड
registered	रेजिस्टेर		रजिस्टर्ड
ratanpur	रतनपुर		रतनपुर
runners	रनर्स		रनर्स
rayan	रायन		रयान
ryan	रियान		रयान
ralhan	रल्हन		रल्हन
ravish	रविषा		रविश
ravael	रवैल		रवैल
ravel	रेवल		रवैल
rawail	रावेल		रवैल
rasad	रसड़ा		रसद
rasaayanik	रासायणिक		रसायनिक
rasaayanika	रासायणिक		रसायनिक
rasayanika	रासायनिक		रसायनिक
rasyanik	रास्यानिक		रसायनिक
rasaayanon	रसायनों		रसायनों
rasayanon	रसायनों		रसायनों
rahamat	रहमत		रहमत
rahmat	रहमत		रहमत
rhamat	रहमत		रहमत
rahenge	रहेंगे		रहेंगे
rahegi	रहेगी		रहेगी
rounder	राउंडर		राउंडर
raak	राक		राक
rak	रक		राक
raakhe	रखे		राखे
rakhe	रखे		राखे
raagon	रागों		रागों
ragon	रगों		रागों
raghavan	रघवान		राघवन
raaj	राज़		राज
raj	राज़		राज
rajkot	राजकोट		राजकोट
rajtantra	राजतंत्र		राजतंत्र
raajneetikaran	राजनीतिकरण		राजनीतीकरण
rajneetikaran	राजनीतिकरण		राजनीतीकरण
rajnitikaran	राजनीतिकरण		राजनीतीकरण
rajma	राजमा		राजमां
rajman	राजमान		राजमां
raajasva	राजस्व		राजस्व
rajasva	राजस्व		राजस्व
raaji	राजी		राजी
raji	राजी		राजी
rajinaama	राजीनामा		राजीनामा
rajinama	राजीनम		राजीनामा
raajon	राजों		राजों
rajon	रामों		राजों
rana	रण		राणा
raatrichar	रातरिचार		रात्रिचर
ratrichar	रातरिचार		रात्रिचर
raadhe	राधे		राधे
radhe	राधे		राधे
ranapur	रणपुर		रानापुर
rabin	रबीन		राबिन
robin	रॉबिन		राबिन
rabha	राभ		राभा
ramkot	रामकोटा		रामकोट
ramkote	रमकोटे		रामकोट
ramtek	राम्टेक		रामटेक
rampur	रामपुरा		रामपुर
rambharose	रामभरोस		रामभरोसे
rambharosey	रामभरोसी		रामभरोसे
ramraj	रामराज		रामराज
raalod	रालोड़		रालोद
ralaud	रालौड़		रालोद
ralod	रालोड़		रालोद
ravaley	रवले		रावले
ravle	रवले		रावले
rasayanik	रासायनिक		रासायनिक
racreation	रैकेशन		रिक्रिएशन
recreation	रिक्रिएशन		रिक्रिएशन
rig	रिग		रिग
riggs	रिग्स		रिग्स
rigs	रिग्स		रिग्स
richual	रिचुआल		रिचुअल
ritual	रित्तुओल		रिचुअल
reduction	रेडक्शन		रिडक्शन
ripan	रिपन		रिपन
ripon	राइपों		रिपन
ria	रि		रिया
riya	रिया		रिया
rishte	रिश्ते		रिश्ते
rishtey	रिश्ते		रिश्ते
risane	रिसने		रिसने
risaney	रिसने		रिसने
risne	रिजने		रिसने
rihana	रिहान		रिहाना
rihanna	रिहानना		रिहाना
regal	रेगल		रीगल
rigal	रिगल		रीगल
reasonal	रिएजनल		रीजनल
regional	रिजनेम		रीजनल
retreate	रिट्रेट		रीट्वीट
retweet	रिट्वीता		रीट्वीट
reeta	रीता		रीता
rita	रीता		रीता
rukate	रुकते		रुकते
rukte	रुकते		रुकते
ruktey	रुकते		रुकते
rugan	रूग्ण		रुग्ण
rugna	रूग्ण		रुग्ण
ruganta	रूगंत		रुग्णता
rugnata	रूग्णता		रुग्णता
rojvelt	रोजवेल्ट		रुजवेल्ट
roojwelt	रूजवेल्ट		रुजवेल्ट
roosevelt	रूजवेल्ट		रुजवेल्ट
rodolph	रॉडल्फ		रुडोल्फ
rudolf	रूडोल्फ		रुडोल्फ
rudolph	रूडोल्फ		रुडोल्फ
roopesh	रूपेश		रुपेश
rupesh	रूपेश		रुपेश
ruby	रूबी		रुबी
roomani	रूमानी		रुमानी
rumani	रूमानी		रुमानी
rukavaton	रुकावटों		रूकावटों
root	रुट		रूट
route	राउत		रूट
rooting	रूटिंग		रूटिंग
routine	राउटिन		रूटिंग
routing	राउटिंग		रूटिंग
roots	रुट्स		रूट्स
routes	राउटेस		रूट्स
roopak	रूपक		रूपक
rupak	रूपक		रूपक
roopi	रूपी		रूपी
rupi	रूपी		रूपी
rantle	रैंटल		रेंटल
rental	रेंटल		रेंटल
registan	रेजिस्टें		रेगिस्तान
registani	रेजिस्टेनी		रेगिस्तानी
reja	रेजा		रेजा
reza	रेज		रेजा
rate	रैट		रेट
rate	रैट		रेत
ret	रेता		रेत
refaeli	रेफली		रेफेली
refeli	रेफली		रेफेली
reshe	रेशे		रेशे
reshey	रेशे		रेशे
race	रेस		रेस
rese	रेज		रेस
racer	रेसर		रेसर
recer	रेसर		रेसर
racing	रेसिंग		रेसिंग
reson	रेसों		रेसों
rehaana	रेहान		रेहाना
rehana	रेहान		रेहाना
racketeer	रैकेटीर		रैकेटियर
racketier	रैकेटियर		रैकेटियर
rectare	रेक्टर		रैकेटियर
radical	रेडिकल		रैडिकल
raidical	रायडिकल		रैडिकल
raith	रैथ		रैथ
rapping	रैपिंग		रैपिंग
wrapping	व्रैपिंग		रैपिंग
robertsan	रोबर्ट्सन		रॉबर्टसन
robertson	रॉबर्ट्सन		रॉबर्टसन
robinson	रॉबिनों		रॉबिंसन
royals	रोएलस्स		रॉयल्स
rojlin	रोजलिन		रोजलिन
rozlyn	रॉजलैन		रोजलिन
rotation	रोटेशन		रोटेशन
rodrigo	रॉडरीगो		रोड्रिगो
ronaldo	रोनाल्डों		रोनाल्डो
ronit	रोनीट		रोनित
roni	रोनी		रोनी
ropane	रोपने		रोपने
ropaney	रोपने		रोपने
ropne	रोपने		रोपने
robin	रॉबिन		रोबिन
roya	रॉय		रोया
rollers	रॉलर्स		रोलर्स
rovan	रोवन		रोवन
rowan	रोवन		रोवन
rosario	रोसरियो		रोसारियो
rosariyo	रोसरियो		रोसारियो
raubadaar	रौबादार		रौबदार
raubadar	रौबादार		रौबदार
raubdar	रौबदार		रौबदार
landara	लंदर		लंगड़ा
langada	लंगाड़		लंगड़ा
langda	लैंगड़ा		लंगड़ा
langar	लंगार		लंगर
langaron	लंगारों		लंगरों
langron	लंगरों		लंगरों
lambi	लंबी		लंबी
lakeer	लकीर		लकीर
lakir	लकिर		लकीर
lakiron	लकिरों		लकीरों
lakme	लकमे		लक्मे
lakshmidhar	लक्ष्मीधर		लक्ष्मीधर
lakshmighar	लक्ष्मीघर		लक्ष्मीधर
lakshy	लक्ष्य		लक्ष्य
lakshya	लक्ष्य		लक्ष्य
lakshyon	लक्ष्यों		लक्ष्यों
lux	लुक्स		लक्स
laksar	लक्षर		लक्सर
luxor	लकोर		लक्सर
lakhkhi	लख्खी		लख्खी
lagna	लगना		लगना
laganewale	लगानेवाले		लगनेवाले
lagnevaaley	लगनेवाले		लगनेवाले
lagnewale	लगनेवाले		लगनेवाले
lagega	लगेगा		लगेगा
lajjalu	लज्जलु		लज्जालु
latkate	लटकते		लटकाते
ladki	लड़की		लड़की
ladate	लाड़ते		लड़ते
ladte	लाड़ते		लड़ते
ladaai	लदाई		लड़ाई
ladai	लदाई		लड़ाई
ladaaiyon	लादाइयों		लड़ाईयों
ladaeyon	लादाएं		लड़ाईयों
ladaiyon	लड़ाइयों		लड़ाईयों
lapetane	लपेटने		लपेटने
lapetne	लपेटने		लपेटने
labada	लाबाद		लबादा
lbada	लबड़		लबादा
labdh	लब्धा		लब्ध
lbdh	लब्धा		लब्ध
lalak	लालक		ललक
lalkarata	लालकर्ता		ललकारता
lalkarta	लालकर्ता		ललकारता
lalla	लाल		लल्ला
lavasa	लावास		लवासा
lovasa	लोवासा		लवासा
lassi	लस्सी		लस्सी
lahanaa	लहन		लहना
lahna	लहना		लहना
lehna	लहना		लहना
lahraee	लहराई		लहराई
lahrai	लहरायी		लहराई
lehrayi	लेहरायी		लहराई
lahalhati	लहालही		लहलहाती
lahlahaati	लहलाती		लहलहाती
lahlahati	लहलहती		लहलहाती
lahsun	लहसून		लहसुन
lasoon	लासून		लहसुन
lanchar	लांचार		लांचर
launcher	लॉन्चेयर		लांचर
lycopene	लिकोपीन		लाइकोपिन
lime	लिमी		लाइम
lives	लिव्ज		लाइव्स
live	लाइव		लाईव
laegi	लाएगी		लाएगी
lagataar	लगातार		लागातार
lagatar	लगातार		लागातार
laata	लात		लाता
lata	लता		लाता
laati	लाती		लाती
lati	लाती		लाती
layega	लाएगा		लायेगा
lalpur	लालपुरा		लालपुर
las	लासा		लास्ट
last	लास्ता		लास्ट
lindbhed	लिंदभेड़		लिंगभेद
lingbhed	लिंगिड़		लिंगभेद
lindan	लिंदन		लिंडन
lindn	लिंडना		लिंडन
lindon	लिंडोन		लिंडन
likhakar	लिखकर		लिखकर
likhkar	लिखकर		लिखकर
ligar	लीगर		लिगर
liger	लीजर		लिगर
liberation	लाइबरेशन		लिबरेशन
libration	लाइब्राटेशन		लिबरेशन
liberation	लाइबरेशन		लिब्रेशन
libration	लाइब्राटेशन		लिब्रेशन
leaderon	लीडरों		लीडरों
leedaron	लीड़रों		लीडरों
lidaron	लिडरों		लीडरों
liidaron	लियादारों		लीडरों
louis	लोई		लुईस
luis	लुईस		लुईस
ludhakate	लुढ़कते		लुढ़कते
ludhkate	लुढ़कते		लुढ़कते
lurhakate	लुढ़कते		लुढ़कते
lutf	लुट्फा		लुत्फ
lumding	लुमिंग		लुमडिंग
lootmaar	लूटमार		लूटमार
lootmar	लूटमार		लूटमार
landal	लैंडल		लेंडल
lendal	लेनदल		लेंडल
lega	लेग		लेगा
legaa	लेग		लेगा
letakar	लेटकर		लेटकर
letkar	लेटकर		लेटकर
lenevali	लेनेवाली		लेनेवाली
lenewali	लेनेवाली		लेनेवाली
label	लैबल		लेबल
labeling	लैबलिंग		लेबलिंग
labelling	लेबेलिंग		लेबलिंग
labelo	लाबेलो		लेबलों
labelon	लेबेलों		लेबलों
lebalon	लेबलों		लेबलों
lemon	लेमॉन		लेमन
laingadan	लेंगदन		लैंगडन
langdon	लंगदों		लैंगडन
lengdan	लेनगान		लैंगडन
laigikata	लैगिकता		लैंगिकता
laingikta	लैंगिकता		लैंगिकता
lanset	लैंसेट		लैंसेट
lenset	लेसेट		लैंसेट
lairi	लैरी		लैरी
lairy	लैरी		लैरी
larry	लैरी		लैरी
lace	लेस		लैस
less	लेस		लैस
locket	लाकेट		लॉकेट
laundry	लॉन्डरी		लॉन्ड्री
longewal	लोंगेवाला		लोंगोवाल
longewala	लोंगेवाला		लोंगोवाल
longoval	लोंगोवाला		लोंगोवाल
log	लॉग		लोग
loge	लॉग		लोगे
lochdar	लोचदार		लोचदार
lodi	लेडी		लोदी
laurence	लॉरेंस		लौरेंस
laurens	लारेंस		लौरेंस
laurense	लॉरेंस		लौरेंस
wonder	वंदर		वंडर
vansh	वंश		वंश
vanshdhar	वंशधार		वंशधर
vanshavad	वंशावद		वंशवाद
vanshvaad	वंशवाद		वंशवाद
vanshvad	वंशवाद		वंशवाद
wanshwad	वंशवाद		वंशवाद
vajood	वाजूद		वजूद
vajud	वाजुदा		वजूद
wajood	वजूद		वजूद
vadali	वादली		वडाली
vadli	वादली		वडाली
wadali	वाडली		वडाली
vanita	वनित		वनिता
vareinye	वारेन्य		वरेण्य
varenya	वरेनी		वरेण्य
varn	वरना		वर्ण
varna	वरना		वर्ण
varnit	वर्नीत		वर्णित
vartamaan	वर्तमान		वर्तमान
vartaman	वर्तमान		वर्तमान
vartmaan	वर्तमान		वर्तमान
vartman	वर्तमान		वर्तमान
varddhaman	वर्द्धमन		वर्द्धमान
vardhmaan	वर्धमान		वर्द्धमान
vardhman	वर्धमान		वर्द्धमान
verbal	वेरबल		वर्बल
varshan	वर्षन		वर्शन
vasharan	वशारणा		वर्शन
vershan	वर्षन		वर्शन
version	वर्जिन		वर्शन
varsaache	वर्साचे		वर्साचे
varsaryache	वर्सरीच		वर्साचे
vasearche	वासेरच		वर्साचे
valkan	वाल्कन		वल्कन
valkkan	वालक्कन		वल्कन
velkan	वेलकन		वल्कन
vash	वाश		वश
vashikaran	वाष्पीकरण		वशीकरण
vaangchuk	वांगचूक		वांगचुक
vangchuk	वांगचुक		वांगचुक
wangchuk	वांगचुक		वांगचुक
want	वंत		वांट
vije	वाइज		वाइज
vise	वाइस		वाइज
wise	वाइस		वाइज
vatar	वातार		वाटर
water	वाटर		वाटर
watson	वत्सों		वाटसन
wattson	वत्सों		वाटसन
vaan	वान		वाण
waan	वान		वाण
vaanon	वानों		वाणों
vanon	वनों		वाणों
wanon	वनों		वाणों
vatanukulan	वातानुकूलन		वातानुकूलन
watanukoollan	वाटनुकूलन		वातानुकूलन
vaadak	वादक		वादक
vadak	वादक		वादक
vaadiyon	वादियों		वादियों
vadiyon	वादियों		वादियों
wadiyon	वादियों		वादियों
vayana	वायन		वायना
vayna	वायन		वायना
wayna	वायना		वायना
wireless	वायरलेस		वायरलेस
wirerless	वायरर्लेस		वायरलेस
warrior	वारियोर		वारियर्स
warriors	वरियोर्स		वारियर्स
valve	वाल्वे		वाल्व
wolv	वॉल्व		वाल्व
vastavik	वास्तविक		वास्तविक
vastvik	वास्तविक		वास्तविक
vaahikayen	वाहिकाएं		वाहिकाएं
vahikayen	वाहिकाएं		वाहिकाएं
wahikayan	वाहिकायन		वाहिकाएं
winter	विंटर		विंटर
vincent	विंसेंट		विंसेंट
vikalpon	विकल्पों		विकल्पों
wicket	विकट		विकेट
vikramjeet	विक्रमजीत		विक्रमजीत
vikramjit	विकृमजित		विक्रमजीत
vichaarakon	विचारकों		विचारकों
vicharakon	विचारकों		विचारकों
vigyan	विज्ञान		विज्ञान
vigyaani	विज्ञानी		विज्ञानी
vigyani	विज्ञानी		विज्ञानी
vigyaanon	विज्ञानों		विज्ञानों
vigyanon	विज्ञानों		विज्ञानों
vitthal	वित्तल		विट्ठल
viththal	विथ्ठल		विठ्ठल
vitthal	वित्तल		विठ्ठल
vitark	विटर्क		वितर्क
vidhaaein	विधाएं		विद्याएं
vidyaayein	विद्याएं		विद्याएं
vidyaen	विद्याएं		विद्याएं
vidhaaon	विधाओं		विद्याओं
vidyaaon	विद्याओं		विद्याओं
vidyaon	विद्याओं		विद्याओं
vidhansabhaein	विद्यानसाएं		विधानसभाएं
vidhansabhaen	विधानसभाएं		विधानसभाएं
vidhivat	विधिवत्		विधिवत
vidhut	विद्युत्		विधुत
vinasht	विनाशता		विनष्ट
vineet	विनीता		विनीत
vinit	विनीता		विनीत
vipreetataa	विप्रीतता		विपरीतता
vipritata	विपरितता		विपरीतता
vipra	विप्र		विप्रा
vipro	विप्रो		विप्रो
wipro	विप्रो		विप्रो
vibha	विभा		विभा
vibhajak	विभाजक		विभाजक
vibhram	विभ्राम		विभ्रम
vibhrm	विभर्म		विभ्रम
vibram	विब्राम		विभ्रम
vimarsh	विमार्श		विमर्श
vimarsho	विमार्शो		विमर्शों
vimarshon	विमार्शों		विमर्शों
virajati	विराजति		विराजती
virechan	विराचन		विरेचन
virodh	विरोध		विरोध
virodhabhasi	विरोधाधासी		विरोधाभासी
virodhabhason	विरोधाभासों		विरोधाभासों
vividh	विविधा		विविध
vivekahin	विवेकहिन		विवेकहीन
vivekheen	विवेखीन		विवेकहीन
visheshan	विषेषण		विशेषण
visheshanon	विशेषानों		विशेषणों
visheshaadhikaar	विशेषाधिकार		विशेषाधिकार
visheshadhikar	विशेषाधिकार		विशेषाधिकार
vishwasaniy	विश्वस्नीय		विश्वसनीय
vishwasniiya	विश्वासनीय		विश्वसनीय
vishwasaniyata	विश्वासनीयता		विश्वसनीयता
vishwasniiyataa	विश्वासनीयता		विश्वसनीयता
vishahin	विषहीन		विषहीन
vishhin	विधिन		विषहीन
vishanu	विषाणु		विष्णु
vishnu	विषणु		विष्णु
vlc	वीएलसी		वीएलसी
weeks	वीक्स		वीक्स
veerchand	वीरचंद		वीरचंद
virchand	विरचंद		वीरचंद
veeresh	वियरेश		वीरेश
viresh	विरेश		वीरेश
vritton	वृत्रों		वृत्तों
vruton	वृतों		वृत्तों
vrutton	वृत्तों		वृत्तों
venkataraman	वेंकटरमण		वेंकटरमन
venkatraman	वेंकटरमण		वेंकटरमन
ved	वेद		वेड
wade	वादे		वेड
wed	वेद		वेड
wedding	वेडिंग		वेडिंग
vediyon	वेदियों		वेदियों
vedon	वेदों		वेदों
venezuela	वेनेज्यूल		वेनेजुएला
veronica	वेरोनिक		वेरोनिका
veronika	वेरोनिक		वेरोनिका
weronika	वेरोनिक		वेरोनिका
velvet	वेलवेट		वेलवेट
welwet	वेलवेट		वेलवेट
welder	वेल्डर		वेल्डर
weldor	वेलदोर		वेल्डर
welding	वेल्डिंग		वेल्डिंग
wealth	विल्थ		वेल्थ
vellur	वेललर		वेल्लूर
velur	वेलफर		वेल्लूर
vesh	वेश		वेश
wasting	वास्टिंग		वेस्टिंग
westing	वेस्टिंग		वेस्टिंग
wastinghouse	वास्टिंघरीज		वेस्टिंगहाउस
westinghouse	वेस्टिंघाउज		वेस्टिंगहाउस
vaisley	वैसले		वेस्ले
vesle	वेसले		वेस्ले
wesle	वेकल		वेस्ले
vaigyaanik	वैज्ञानिक		वैज्ञानिक
vaigyanik	वैज्ञानिक		वैज्ञानिक
vegyanik	वेज्ञानिक		वैज्ञानिक
vaigyaanikta	वैज्ञानिकता		वैज्ञानिकता
vaigyanikata	वैज्ञानिकता		वैज्ञानिकता
vaigyanikta	वैज्ञानिकता		वैज्ञानिकता
vaitravati	वैत्रवति		वैत्रवती
vaitrawati	वैत्रवती		वैत्रवती
vaimanasy	वैमानसी		वैमनस्य
vaimanasya	वैमानसी		वैमनस्य
vaimanya	वैमान्य		वैमनस्य
very	वेरी		वैरी
vaisaakh	वैसाख		वैशाख
vaishakh	वैशख		वैशाख
vaishaakhi	वैशाखी		वैशाखी
vaishakhi	वैशखी		वैशाखी
vaishnodevi	वैष्णोदेवी		वैष्णोदेवी
vyaktigat	व्यक्तिगता		व्यक्तिगत
vyagr	व्याग्र		व्यग्र
vyagra	व्याग्र		व्यग्र
vyatit	व्यतित		व्यतीत
vytit	व्यृत		व्यतीत
vyabhichar	व्याभिचार		व्यभिचार
vyabhichari	व्याभिचारी		व्यभिचार
vyavadhan	व्यवधान		व्यवधान
vyavdhan	व्यवधान		व्यवधान
vyavahargat	व्यवहारगता		व्यवहारगत
vyvhargat	व्यवहारग		व्यवहारगत
vyaghat	व्याघात		व्याघात
vyapak	व्यापक		व्यापक
vlad	व्लाद		व्लाद
wlaad	वादाद		व्लाद
vladimir	व्लादीमीर		व्लादिमीर
shanghai	शांघाई		शंघाई
shatpath	शाप्पत		शतपथ
shanivar	शनिवर		शनिवार
shaniwar	शनिवार		शनिवार
shabana	शबन		शबाना
shbana	शबन		शबाना
shabdarth	शबदर्थ		शब्दार्थ
shamadan	शमादान		शमादान
shmadan	शमादन		शमादान
shamitabh	शमीताभ		शमिताभ
shamil	शामिल		शमिल
shmil	श्मील		शमिल
sharabon	शर्बों		शराबों
shrabon	शराबों		शराबों
shararat	शरारता		शरारत
shrart	शरारता		शरारत
sharmana	शर्मन		शर्माना
shaharwasiyon	शहरवासियों		शहरवासियों
shahrvasiyon	शहरवासियों		शहरवासियों
shervasiyon	शेरवासियों		शहरवासियों
shahdara	शाहदर		शहादरा
shaantikaal	शांतिकाल		शांतिकाल
shantikal	शांतिकाल		शांतिकाल
shaao	स्षाओ		शाओ
shao	साओ		शाओ
shaakir	शाकीर		शाकिर
shakir	शकीर		शाकिर
shaakhaaen	शाखाएं		शाखाएं
shakhayan	शाख्यान		शाखाएं
shakhayen	शाखाएं		शाखाएं
shayak	शयक		शायक
shaavakon	शावकों		शावकों
shavakon	शावकों		शावकों
shavkon	शवकों		शावकों
shaasaka	शासक		शासक
shasak	शासक		शासक
sasakon	सासों		शासकों
shaasakon	शासकों		शासकों
shasakon	शासकों		शासकों
shipra	शिप्र		शिप्रा
shirke	शिरके		शिर्के
sheershakon	शीर्षकों		शीर्षकों
shirshakon	शिर्षकों		शीर्षकों
shirshkon	शिर्षकों		शीर्षकों
shujaat	शुजात		शुजात
shujat	शुजात		शुजात
shooting	शूटिंग		शुटिंग
shutting	शटिंग		शुटिंग
should	शौल्ड		शुड
shud	शुदा		शुड
shubhankar	शुभंकर		शुभंकर
shumaali	शुमाली		शुमाली
shumali	शुमाली		शुमाली
shringaar	श्रींगार		शृंगार
shringar	श्रृंगार		शृंगार
shrungar	शृंगार		शृंगार
sheling	शेलिंग		शेलिंग
shelling	शेलिंग		शेलिंग
shaili	शैली		शैली
shaly	शल्य		शैली
sheli	शेली		शैली
shaishav	शैशव		शैशव
sean	सिएन		शॉन
shaun	शौन		शॉन
shawn	शावन		शॉन
short	शोर्ट		शोर्ट
sure	सुरे		श्योर
shrankhala	श्रृंखला		श्रंखला
shrankhalaa	श्रृंखला		श्रंखला
shrunkhla	शृंखला		श्रंखला
shrankhalaaon	श्रृंखलाओं		श्रंखलाओं
shrinkhalaon	शृंखलाओं		श्रंखलाओं
shrunkhlaon	शृंखलाओं		श्रंखलाओं
shravani	श्रवणी		श्रावणी
shrikar	श्रीकर		श्रीकर
shrikhand	श्रीखंड		श्रीखंड
shrimati	श्रीमती		श्रीमति
shriram	श्रीराम		श्रीराम
sriram	श्रीराम		श्रीराम
shrotaon	श्रोतों		श्रोताओं
shat	शत		षट्
sankhyaein	संख्याएं		संख्याएं
sankhyaen	संख्याएं		संख्याएं
sankhyayen	संख्यायन		संख्याएं
sanghanit	संघानित		संघनित
sanghnit	संघ्नित		संघनित
sanchayan	संचयन		संचयन
sanchar	संचर		संचार
sanchaari	सांचारी		संचारी
sanchari	सांचरी		संचारी
sanchalanon	संचलनों		संचालनों
sanchalnon	संचलनों		संचालनों
sanjay	संजय		संजय
sanjeevan	संजीवन		संजीवन
sanjivan	संजीवन		संजीवन
santati	संतती		संतति
sandarbh	संदर्भ		संदर्भ
sandarbha	संदर्भ		संदर्भ
sandrbh	संदबभ		संदर्भ
sandarbhon	संदर्भों		संदर्भों
sandrbhon	संदब्भों		संदर्भों
sandali	सांडली		संदली
sandli	सांडली		संदली
sandhan	संधन		संधान
samprati	संप्रति		संप्रति
samprti	संप्रति		संप्रति
samprabhu	संप्रभु		संप्रभु
samprbhu	संप्रभु		संप्रभु
samprabhuta	संप्रभूत		संप्रभुता
samprbhuta	संप्रभूत		संप्रभुता
sambit	संबित		संबित
sambhalane	संभालने		संभालने
sambhalne	संभालने		संभालने
sambhrant	संभरांत		संभ्रांत
sanbharnt	संभर्णता		संभ्रांत
sanyog	संयोग		संयुक्त
sanyukt	संयुक्त		संयुक्त
sanyukta	संयुक्त		संयुक्त
sanyukta	संयुक्त		संयुक्ता
sanyogvash	संयोग्वश		संयोगवश
sanyojan	संयोजन		संयोजन
sanyojanon	संयोजनों		संयोजनों
sanyojnon	संयोजनों		संयोजनों
samvedikaran	संवेदीकरण		संवेदीकरण
sanvedikaran	संवेदीकरण		संवेदीकरण
samshayon	समाशयों		संशयों
sanshayon	संशयों		संशयों
sanshyon	संश्यों		संशयों
sanskaar	संस्कार		संस्कार
sanskar	सांस्कर		संस्कार
sanskaari	संस्कारी		संस्कारी
sanskari	सांस्कारी		संस्कारी
sanskrit	संस्कृत		संस्कृत
sanskurt	संस्कृत		संस्कृत
sanskritiyan	संस्तृतियां		संस्कृतियां
sanskrutiyan	संस्कृतियां		संस्कृतियां
sanskritiyon	संस्कृतियों		संस्कृतियों
sanskrutiyon	संस्कृतियों		संस्कृतियों
sanasthit	सानस्थित		संस्थित
sansthit	संस्थित		संस्थित
sanasthita	सानस्थित		संस्थिता
sansthita	संस्थित		संस्थिता
sakara	साकार		सकरा
sakra	सक्र		सकरा
sakshan	साक्षण		सक्शन
suction	सुक्शन		सक्शन
sacchidanand	सच्चिदानंद		सच्चिदानंद
sachhidanand	सच्चिदानंद		सच्चिदानंद
sachidanand	सचीदंद		सच्चिदानंद
sajja	सज्जा		सज्जा
sat	सात		सत
satpal	सत्पल		सतपाल
satluj	सतलुज		सतलुज
sataane	सताने		सताने
satane	सातने		सताने
sate	सेट		सते
satti	सत्ती		सत्ती
satvat	सत्वता		सत्वत
sadanand	सदानंद		सदानंद
sapane	सपने		सपने
sapne	सपने		सपने
sapney	सपनेय		सपने
saparivaar	सपरिवार		सपरिवार
sapariwar	सपरिवार		सपरिवार
sparivar	स्परिवार		सपरिवार
sapaat	सपात		सपाट
sapat	सपात		सपाट
sapate	सपते		सपाटे
sapatey	सपते		सपाटे
saptakranti	सप्तक्रांति		सप्तक्रांति
saptkraanti	सप्तक्रांति		सप्तक्रांति
saptapadi	सप्तापदी		सप्तपदी
saptpadi	सप्त्पादी		सप्तपदी
saptari	सप्तारी		सप्तरी
sapramaan	सप्रमान		सप्रमाण
sapraman	सप्रमान		सप्रमाण
submit	सबमित		सबमिट
sabmission	सबमिशन		सबमिशन
submission	सबमिशन		सबमिशन
sabhaein	सभाएं		सभाएं
sabhaen	सभाएं		सभाएं
sabhayen	सभाएं		सभाएं
sabhen	सभेन		सभाएं
sabhasadon	सभासदों		सभासदों
sabhyata	सभ्यता		सभ्यता
samjhoonga	समझूनग		समझूंगा
samjhunga	समझूनग		समझूंगा
samjhungaa	समझूनग		समझूंगा
saman	सामान		समन
samanvayaka	सामान्वयक		समन्वयक
samanwayaka	सामान्वयक		समन्वयक
samnvyak	साम्नवयक		समन्वयक
samaadhaan	समाधान		समाधान
samadhan	समाधन		समाधान
samadhiyon	समाधियों		समाधियों
samadjiyon	समद्जियों		समाधियों
samalakha	समालखा		समालखा
samalakhaa	समालखा		समालखा
samahaar	समाहार		समाहार
samahar	समहार		समाहार
samitiyan	समितियां		समितियां
sametati	समेटती		समेटती
sametti	समेटी		समेटती
sarka	सार्क		सरका
sarkaa	सार्क		सरका
sarkarein	सरकरें		सरकारें
sarkaren	सरकरें		सरकारें
sarkaaron	सर्कारों		सरकारों
sarkaron	सर्कारों		सरकारों
sargana	सरगना		सरगना
sarganaon	सरगनाओं		सरगनाओं
sargi	सरगी		सरगी
sarguja	सरगुज		सरगुजा
sarjuga	सरजूग		सरगुजा
sarsa	सर्स		सरसा
sarsaa	सर्स		सरसा
sarahind	सराहिंद		सरहिंद
sarhind	सरहिंद		सरहिंद
sirhind	सिरहिंद		सरहिंद
saraaha	सराह		सराहा
saraha	साराह		सराहा
saraahi	सराही		सराही
sarahi	शराही		सराही
salaahkar	सलाहकर		सलाहकार
salahkaar	सलाहकर		सलाहकार
salahkar	सालाहकर		सलाहकार
saleeb	सलीब		सलीब
salib	सालिब		सलीब
select	सेलेक्ट		सलेक्ट
saltanat	सल्टनता		सल्तनत
saltnat	सल्टनता		सल्तनत
savaal	सवाल		सवाल
saval	सावला		सवाल
sawaal	सवाल		सवाल
sawal	सवाल		सवाल
sahakalaakar	सहकालकर		सहकलाकार
sahakalakar	सहकालकर		सहकलाकार
sahkalakar	सहकलकर		सहकलाकार
sahadev	सहादेव		सहदेव
sahdev	सहदेव		सहदेव
sahrawat	सहरावत		सहरावत
sherawat	शेरावत		सहरावत
sahooliyata	सहूलियत		सहूलियत
sahuliyat	सहूलियता		सहूलियत
sahuuliyata	सहूलियत		सहूलियत
saanketika	सांकेतिक		सांकेतिक
sanketik	सांकेतिक		सांकेतिक
saimans	सायमंस		साइमंस
simmons	सीम्मैनस		साइमंस
symons	सायमंस		साइमंस
saima	सैम		साइमा
sagarika	सागरिक		सागरिका
sagrika	सागरिक		सागरिका
saga	साग		सागा
saajan	साजन		साजन
sajan	सजना		साजन
saajsajja	साजसज्ज		साजसज्जा
sajsajja	सजसज्ज्ज		साजसज्जा
saja	सजा		साजा
saathsaath	साठसाथ		साथसाथ
sathsath	साठस्थ		साथसाथ
sathiya	स्थिया		साथिया
saabah	साबाह		साबाह
sabah	सबाह		साबाह
samanjasy	समांजस्य		सामंजस्य
samanjasya	समांजस्य		सामंजस्य
samoa	सामो		सामोआ
samoaa	सामो		सामोआ
saayn	सायन		सायं
sayan	सायन		सायं
saym	सैम		सायं
saira	सैर		सायरा
sayara	सैयर		सायरा
sayra	सायर		सायरा
salve	साल्वे		साल्वे
sahab	सहाब		साहब
singapore	सिंगापर		सिंगापुर
singaar	सिंगारा		सिंगार
singar	सिंगारा		सिंगार
singer	सिंगर		सिंगार
singhaadey	सिंहादे		सिंघाड़े
singhade	सिंघदे		सिंघाड़े
singhde	सिंहदे		सिंघाड़े
singhre	सिंहरे		सिंघाड़े
singhi	सिंही		सिंघी
singha	सिन्हा		सिंहा
sinha	सिन्हा		सिंहा
siera	सीयर		सिएरा
sierra	सियरा		सिएरा
sikud	सिकुड़		सिकुड़
signals	सिग्नल्स		सिगनल्स
cigaretton	साइग्गेटन		सिगरेटों
cigretton	साइग्रेटन		सिगरेटों
siddhivat	सिद्धिवता		सिद्धवट
siddhvat	सिद्धवता		सिद्धवट
siddhwat	सिद्धवता		सिद्धवट
sinabang	सिनाबेंग		सिनाबंग
synapse	सिनापेज		सिनेप्स
sipah	सिपाह		सिपाह
sipaha	सिपाह		सिपाह
sipahiyon	सीपियों		सिपाहियों
sipahi	सीपाही		सिपाही
sim	सीमा		सिम
simat	सीमत		सिमट
simatataa	सीमता		सिमटता
simatta	सीमत्त		सिमटता
simtata	सीमताता		सिमटता
simtataa	सीमताता		सिमटता
cement	सीमेंट		सिमटे
simate	सिमेट		सिमटे
simi	सीमी		सिमी
simmy	सिमी		सिमी
sims	सीम्स		सिम्स
siyasi	सियासी		सियासी
siyah	सियाह		सियाह
siyaha	सियाह		सियाह
sirpur	सीरपुर		सिरपुर
sivan	सिवन		सिवान
siwan	सिवन		सिवान
sisva	सिस्वा		सिसवा
siswa	सिस्वा		सिसवा
cil	सील		सीआईएल
csi	सीएसआई		सीएसआई
sikar	सिकर		सीकर
seaten	सीटन		सीटें
sitaram	सीतारम		सीताराम
sitaharan	सीताहरण		सीताहरण
cpm	सीपीएम		सीपीएम
cps	सीपीएप		सीपीएस
cbse	सीबीएस		सीबीएसई
seem	सीमा		सीम
sim	सीमा		सीम
sealed	सील्ड		सील्ड
shield	शील्ड		सील्ड
ccd	सीएचडीडी		सीसीडी
sugamata	सुगमत		सुगमता
sugmta	सुगमता		सुगमता
sujan	सूजन		सुजेन
sujen	सूजें		सुजेन
suken	सूकें		सुजेन
sujain	सुजाइन		सुजैन
sujhaati	सुझाती		सुझाती
sujhati	सुझाती		सुझाती
sutali	सूतली		सुतली
sutli	सूली		सुतली
suta	सूत		सुता
sdueep	श्रुईप		सुदीप
sudip	सुदीप		सुदीप
sudhaargrah	सुधारग्रह		सुधारगृह
sudhargrih	सूधारगृह		सुधारगृह
sudhargruh	सुधारगृह		सुधारगृह
sunaaron	सुनारों		सुनारों
sunaron	सुनारों		सुनारों
sunaseer	सुनासीर		सुनासीर
sunasir	सुनासिर		सुनासीर
suneeti	सुनीती		सुनीति
suniti	सुनीती		सुनीति
sunega	सुनेगा		सुनेगा
suneyga	सुनेग		सुनेगा
superhit	सुपरहित		सुपरहिट
supachy	सुपच्य		सुपाच्य
supachya	सुपच्य		सुपाच्य
supachye	सुपच्य		सुपाच्य
subhaay	सुभाय		सुभाय
subhay	सुभय		सुभाय
surveen	सर्वीन		सुरवीन
survin	सर्विन		सुरवीन
surana	सुरण		सुराणा
sulkhan	सुलखाना		सुलखान
suljaayi	सुलझाई		सुलझाई
suljayi	सुलझाई		सुलझाई
suljhai	सुलझाई		सुलझाई
sulzai	सुलझाई		सुलझाई
sultana	सुल्ताना		सुलताना
sulaati	सुलाती		सुलाती
sulati	सुलाती		सुलाती
susanskrit	सुसंस्कृत		सुसंस्कृत
susanskrut	सुसंस्कृत		सुसंस्कृत
suhagin	सुहागीन		सुहागिन
soond	सूंड		सूंड़
sund	सूंड		सूंड़
suiyan	सूइयां		सूइयां
sukhati	सूखती		सूखती
sukhti	सूखती		सूखती
sukhakar	सूखकर		सूखाकर
soochak	सूचक		सूचक
suchak	सूचक		सूचक
sooja	सूजा		सूजा
suja	सुजा		सूजा
suba	सब		सूबा
sube	सबे		सूबे
sooraj	सूरज		सूरज
suraj	सुरज		सूरज
surinaam	सुरीनाम		सूरीनाम
surinama	सुरीनामा		सूरीनाम
suriname	सुरीनमे		सूरीनाम
suryadev	सूर्यादेव		सूर्यदेव
sendha	सेंध		सेंधा
senvai	सेनवाई		सेंवई
sevai	सेवाई		सेंवई
sensing	सेंसिंग		सेंसिंग
sexual	सेक्वल		सेक्सुअल
saturday	सतुर्दय		सेटरडे
seti	सेती		सेटी
seto	सेटो		सेटो
seth	सेठ		सेथ
safety	सेफ़्टी		सेफ्टी
semen	सेमें		सेमिन
semin	सेमिना		सेमिन
self	सेल्फा		सेल्फ
selfie	सेल्फी		सेल्फी
save	सावे		सेव
sev	सेवा		सेव
sevakon	सेवकों		सेवकों
sevkon	सेवकों		सेवकों
samuels	सम्यूल्स		सैम्युल्स
celery	सिलरी		सैलरी
salary	सैलानी		सैलरी
sakar	साकार		सॉकर
socar	सोकार		सॉकर
soccer	सोस्सर		सॉकर
songs	सांग्स		सॉन्ग्स
solicitor	सोलीसिटर		सॉलिसिटर
sochane	सोचने		सोचने
sochne	सोचने		सोचने
sonu	सोनु		सोनू
soma	सोमा		सोमा
spma	एसपीएम		सोमा
somi	सोमी		सोमी
soy	सोया		सोय
soya	सोया		सोया
solitaire	सोलीटर		सोलिटेयर
soharai	सोहराय		सोहराई
sohrai	सोहराई		सोहराई
sohaval	सोहवाल		सोहावल
sohawal	सोहवाल		सोहावल
saunpane	सौनपने		सौंपने
sonpne	सोंपने		सौंपने
scala	स्केल		स्काला
skala	स्काल		स्काला
ski	एसीआईए		स्की
scootaron	स्कूटरों		स्कूटरों
scooteron	स्कूटरों		स्कूटरों
skootaron	स्कूटरों		स्कूटरों
scandinavia	स्कैंडिनवी		स्कैंडिनेविया
scaining	स्केनिंग		स्कैनिंग
scanning	स्कैनिंग		स्कैनिंग
squash	स्क्वश		स्क्वाश
squash	स्क्वश		स्क्वैश
skhalan	स्खलन		स्खलन
stain	स्टेन		स्टैन
stan	स्टेन		स्टैन
stop	स्तोप		स्टॉप
stops	स्टॉप्स		स्टॉप्स
stone	स्टोन		स्टोन
straws	स्ट्रैस		स्ट्रास
stress	स्ट्रेस		स्ट्रास
stra	स्ट्रा		स्ट्रे
stray	स्ट्रे		स्ट्रे
stre	स्त्री		स्ट्रे
strocks	स्ट्रॉक्स		स्ट्रोक्स
strokes	स्ट्रोक्स		स्ट्रोक्स
stan	स्टेन		स्तन
stanadhari	स्तनधारी		स्तनधारी
standhaari	स्तंधारी		स्तनधारी
standhari	स्तंधारी		स्तनधारी
sthiti	स्थिति		स्तिथि
stithi	स्तिथि		स्तिथि
stuti	स्तूती		स्तुति
sthitiyaan	स्थितियां		स्थितियां
sthitiyan	स्थितियां		स्थितियां
sthitiyon	स्थितियों		स्थितियों
sthool	स्थूल		स्थूल
sthul	स्थल		स्थूल
sthoolta	स्थूलता		स्थूलता
sthulata	स्थूलता		स्थूलता
sneakers	स्नेकर्स		स्नीकर्स
snickers	स्निकर्स		स्नीकर्स
snikarse	स्निकर्स		स्नीकर्स
spear	स्पेयर		स्पीयर
spell	स्पेल		स्पेल
spelar	स्पेलर		स्पेलर
speller	स्पेलर		स्पेलर
sprint	स्प्रिंट		स्प्रिट
sprit	स्प्रीट		स्प्रिट
spray	सप्रय		स्प्रे
spry	स्प्री		स्प्रे
sfoorti	स्फूर्ति		स्फूर्ति
sfurti	स्फूर्ति		स्फूर्ति
sphoorti	स्फूर्ति		स्फूर्ति
slide	स्लाइड		स्लाइड
slider	स्लाइडर		स्लाइडर
slaaidon	स्लाइडन		स्लाइडों
slidon	स्लीडों		स्लाइडों
sliders	स्लाइडर्स		स्लाइड्स
slides	स्लाइड्स		स्लाइड्स
slice	स्लाइस		स्लाइस
slash	स्लैश		स्लैश
swaroopon	स्वरूपों		स्वरुपों
swarupon	स्वरूपों		स्वरुपों
swa	एसवी		स्वा
swaachaalit	स्वाचालित		स्वाचालित
swachalit	स्वचालित		स्वाचालित
swaarthparak	स्वार्थपरक		स्वार्थपरक
swarthparak	स्वर्थपारक		स्वार्थपरक
swiftlate	स्विफ्टलेट		स्विफ्टलेट
swiftlet	स्विफ्टलेट		स्विफ्टलेट
sweekarte	स्वीकर्ते		स्वीकारते
swikarte	स्वीकार्टे		स्वीकारते
sweet	स्वीत		स्वीट
sweep	स्वीप		स्वीप
sweccha	स्वेच्छा		स्वेच्छा
swecha	स्वेच		स्वेच्छा
swechha	स्वेच्छा		स्वेच्छा
sweta	स्वेटा		स्वेता
swap	स्वाप		स्वैप
swipe	स्वीप		स्वैप
handiya	हंडिया		हंडिया
handiyaa	हंडिया		हंडिया
hundiya	हुंडिया		हंडिया
hakikat	हाकिकता		हकीकत
haqeeqat	हकीकत		हकीकत
hathiya	हठिया		हथिया
hamala	हमल		हमला
hamla	हमला		हमला
hamalavar	हमलावर		हमलावर
hamlavar	हमलावर		हमलावर
humlavar	हमलावर		हमलावर
hamaal	हमाल		हमाल
hamal	हमल		हमाल
hercules	हर्कल्स		हरक्यूलिस
hardas	हरदास		हरदास
harpaal	हरपाल		हरपाल
harpal	हरपल		हरपाल
harvansh	हरवंश		हरवंश
haraval	हरावला		हरावल
harawal	हरावल		हरावल
hurricane	हर्रीकने		हरिकेन
harijan	हरीजन		हरिजन
hariyali	हरियाली		हरियाली
harshit	हर्षित		हर्षित
haldi	हल्दी		हल्दी
halla	हॉल		हल्ला
hawamahal	हवामहाल		हवामहल
hawalaat	हवालाता		हवालात
hawalat	हवलता		हवालात
hasino	हसीनो		हसीनों
hasinon	हासिनों		हसीनों
haan	हान		हां
han	हान		हां
haanfte	हांफते		हांफते
hafate	हफाते		हांफते
hanfte	हैंफ्ट		हांफते
higman	हिजमन		हाइमन
hymen	हमीन		हाइमन
hadauti	हादौति		हाड़ौती
haani	हानी		हानी
hani	हानि		हानी
haarjeet	हार्जीत		हारजीत
harjeet	हरजीत		हारजीत
haaranaa	हारण		हारना
harana	हरण		हारना
harna	हरन		हारना
haalchaal	हालचाल		हालचाल
haalchal	हालचाल		हालचाल
halchaal	हलचाल		हालचाल
halchal	हलचल		हालचाल
halt	हलता		हाल्ट
hault	हौलता		हाल्ट
hahakar	हहाकर		हाहाकार
hingis	हिंगिस		हिंगिस
hindan	हिंदन		हिंडन
hindon	हिंदों		हिंडन
hijada	हिजड़ा		हिजड़ा
hijda	हिजड़ा		हिजड़ा
hijbul	हिजबुल		हिजबुल
hippo	हिप्पो		हिप्पो
hippopotamus	हिप्पोपोटमुस		हिप्पोपोटेमस
himali	हिमाली		हिमाली
hilane	हिलाने		हिलने
hilne	हिलने		हिलने
hisham	हिशम		हिशाम
heeraganj	हीरागंज		हीरागंज
hiraganj	हिरागंज		हीरागंज
heroes	हेरोज		हीरोज
heros	हेरोस		हीरोज
hui	हुइ		हुईं
huin	हुना		हुईं
hooper	हूपर		हूपर
huppar	हप्पर		हूपर
hupper	हप्पर		हूपर
hegde	हागड़े		हेगडे
hemvati	हैमवती		हेमवती
hemwati	हैमवती		हेमवती
help	हेलपा		हेल्प
helper	हेलपर		हेल्पर
haito	हैतों		हैतो
hairam	हैराम		हैरम
harem	हरीम		हैरम
herald	हेरॉल्ड		हैराल्ड
haive	हैव		हैव
have	हवे		हैव
hong	होंग		हॉन्ग
half	हाफ		हॉफ
hoaf	होफ		हॉफ
hounga	हाउंग		होऊंगा
holding	होल्डिंग		होल्डिंग
hoshangabaad	होशांगादाद		होशंगाबाद
hoshangabad	होशांगाबाद		होशंगाबाद
hostes	होस्टेस		होस्टेस
hostess	होस्टेस		होस्टेस
